opDate,Unnamed: 0,rzye,rzmre,rqyl,rqylje,rqmcl,rzrqjyzl
2010-03-31,184,5824813,5866316,2900,24142,3100,5848955
2010-04-01,183,6842114,1054024,2200,17325,0,6859439
2010-04-02,182,6762781,207516,1500,11929,0,6774710
2010-04-06,181,10091243,3329461,1400,10267,0,10101510
2010-04-07,180,25086826,15141395,2800,38418,1400,25125244
2010-04-08,179,30233781,5147142,1400,10110,0,30243891
2010-04-09,178,50663640,22077191,1400,10197,0,50673837
2010-04-12,177,89060984,40376602,1400,10092,5000,89071076
2010-04-13,176,92169145,17444196,5200,211445,3900,92380590
2010-04-14,175,89480507,7964900,5100,212231,0,89692738
2010-04-15,174,103099287,20916787,6200,271214,1100,103370501
2010-04-16,173,121064474,25841176,24500,1198858,19300,122263332
2010-04-19,172,112783831,8395193,22000,1031561,1500,113815392
2010-04-20,171,116673356,5706716,33400,1638860,525900,118312216
2010-04-21,170,127565065,14384413,110300,2513143,97300,130078208
2010-04-22,169,157219058,32603174,135400,2932237,192400,160151295
2010-04-23,168,152902064,17574818,137600,2830321,15700,155732385
2010-04-26,167,182090321,35141973,278900,11042183,193800,193132504
2010-04-27,166,202494937,29621581,142500,2758191,76000,205253128
2010-04-28,165,223249365,31144701,136600,2709735,2100,225959100
2010-04-29,164,233030157,27561491,137763,2847328,12363,235877485
2010-04-30,163,235526412,27804556,130863,2551528,20400,238077940
2010-05-04,162,242846863,21944030,200763,3519010,116400,246365873
2010-05-05,161,277495916,50597915,286963,5144755,101100,282640671
2010-05-06,160,314003383,55666699,183263,3286323,15400,317289706
2010-05-07,159,309938569,48359014,204363,4275122,59300,314213691
2010-05-10,158,327370089,36414703,310636,6273327,181436,333643416
2010-05-11,157,350667983,47067392,302868,6053063,144200,356721046
2010-05-12,156,376113669,43090277,357000,6718753,246200,382832422
2010-05-13,155,393357604,43516642,420400,8409102,156800,401766706
2010-05-14,154,415983876,43883229,391106,6807124,296106,422791000
2010-05-17,153,473201524,74027562,304500,4442929,24200,477644453
2010-05-18,152,467622771,32532723,291000,5137036,135000,472759807
2010-05-19,151,475810742,28129781,374900,5307357,224067,481118099
2010-05-20,150,486806982,32023540,768093,9010047,727990,495817029
2010-05-21,149,503728469,51052980,389690,8942658,346500,512671127
2010-05-24,148,534671504,76158631,1559490,14057930,1226200,548729434
2010-05-25,147,562759014,56337279,485200,10017758,146900,572776772
2010-05-26,146,565966886,17672866,474000,9060668,48300,575027554
2010-05-27,145,604281887,69689203,310600,5436101,26200,609717988
2010-05-28,144,633696229,56487576,239300,4162822,45000,637859051
2010-05-31,143,629837529,37471239,1974600,10343585,1810900,640181114
2010-06-01,142,639998626,41486233,2343493,12838683,435931,652837309
2010-06-02,141,653397284,27207650,2342631,12525827,44600,665923111
2010-06-03,140,675126222,38752924,2434617,14194808,147786,689321030
2010-06-04,139,680721701,31729497,2472131,14822564,119400,695544265
2010-06-07,138,685693950,28140634,281931,6756505,98200,692450455
2010-06-08,137,697311113,34230923,241031,4737840,87500,702048953
2010-06-09,136,785253681,126771313,409431,9413470,281700,794667151
2010-06-10,135,793255677,41796850,347231,7456056,105400,800711733
2010-06-11,134,782619926,44972146,334618,7216554,56218,789836480
2010-06-17,133,802191743,35258695,334518,6931429,41900,809123172
2010-06-18,132,819295645,46482526,298251,5861101,63541,825156746
2010-06-21,131,859456754,99484877,414051,9530834,204100,868987588
2010-06-22,130,867189284,42295789,413651,10065984,29900,877255268
2010-06-23,129,842719148,47607058,364651,8465580,44600,851184728
2010-06-24,128,866091036,47947796,346051,8977774,55200,875068810
2010-06-25,127,877045659,30535042,361467,9449157,139803,886494816
2010-06-28,126,907046989,52375764,393079,8937135,115300,915984124
2010-06-29,125,901933545,56320628,365444,8772089,153911,910705634
2010-06-30,124,908521076,35114468,327344,8247937,149700,916769013
2010-07-01,123,928736463,42612154,435844,9185768,123100,937922231
2010-07-02,122,946500624,55619277,435344,9352154,123700,955852778
2010-07-05,121,1035344028,118587870,428744,9394483,104096,1044738511
2010-07-06,120,1057442951,59076920,444633,9638251,116200,1067081202
2010-07-07,119,1064383786,44925331,466733,9798533,116400,1074182319
2010-07-08,118,1102548838,65542507,493933,10084050,126900,1112632888
2010-07-09,117,1170639291,157020933,561433,11009953,141000,1181649244
2010-07-12,116,1222983113,122496033,583333,11397184,51100,1234380297
2010-07-13,115,1311949508,122088757,632033,11843759,92400,1323793267
2010-07-14,114,1263477734,80227880,646733,12064921,156700,1275542655
2010-07-15,113,1287501800,60785184,584433,11102706,34500,1298604506
2010-07-16,112,1319305043,47955270,578433,11100827,63100,1330405870
2010-07-19,111,1303905018,71278412,611033,11856372,88900,1315761390
2010-07-20,110,1440850708,212954187,612483,12001535,123700,1452852243
2010-07-21,109,1472317314,100091861,508033,10765589,35000,1483082903
2010-07-22,108,1498641789,89420614,516133,10950510,21800,1509592299
2010-07-23,107,1539431335,149445421,540743,11236586,84000,1550667921
2010-07-26,106,1551684452,71587341,662543,12879111,194500,1564563563
2010-07-27,105,1580807913,79519953,657933,12761026,42300,1593568939
2010-07-28,104,1583742413,108644824,585884,12138814,110851,1595881227
2010-07-29,103,1531824312,98484393,566584,12045927,97800,1543870239
2010-07-30,102,1552855454,92133368,501984,11038366,27800,1563893820
2010-08-02,101,1640972044,174443309,473984,10476961,48800,1651449005
2010-08-03,100,1664552954,129466269,512284,10911462,89600,1675464416
2010-08-04,99,1709199891,126248395,336784,8847500,72900,1718047391
2010-08-05,98,1775576845,167459563,287233,8153166,22700,1783730011
2010-08-06,97,1802240599,111988470,305433,8124270,57000,1810364869
2010-08-09,96,1841103737,125992494,393533,9550619,121100,1850654356
2010-08-10,95,1869121672,147571316,398133,8994919,100400,1878116591
2010-08-11,94,1903636176,94087853,343633,8956495,31900,1912592671
2010-08-12,93,1917657100,97853482,389033,9417267,111600,1927074367
2010-08-13,92,1946004866,104210434,346333,9002846,52900,1955007712
2010-08-16,91,2011265809,163870333,373733,9432818,68800,2020698627
2010-08-17,90,2052174441,137843946,309233,8541510,43700,2060715951
2010-08-18,89,2085438731,136209711,335533,9108477,162900,2094547208
2010-08-19,88,2111575425,204734599,386833,10610725,133500,2122186150
2010-08-20,87,2116441794,140901472,267833,7995830,81260,2124437624
2010-08-23,86,2141737847,113225964,341633,8364909,116500,2150102756
2010-08-24,85,2213911577,143827323,383389,9111951,105200,2223023528
2010-08-25,84,2190791657,98774816,458789,9046741,169156,2199838398
2010-08-26,83,2194536639,76108498,572045,9607119,155600,2204143758
2010-08-27,82,2220473978,88446491,523445,9352048,23800,2229826026
2010-08-30,81,2285460219,177968857,305845,8624182,71300,2294084401
2010-08-31,80,2307041382,154108208,521045,10113191,255200,2317154573
2010-09-01,79,2322415396,165106740,469945,8972215,110300,2331387611
2010-09-02,78,2367547449,198711616,425345,7587947,95300,2375135396
2010-09-03,77,2347176762,143306467,436544,6786496,55200,2353963258
2010-09-06,76,2387662569,184925685,468544,9436998,80100,2397099567
2010-09-07,75,2414136562,134071867,489245,8658064,115100,2422794626
2010-09-08,74,2493160533,213749417,349545,6860345,60900,2500020878
2010-09-09,73,2568993058,228372953,228045,5937879,63600,2574930937
2010-09-10,72,2568640986,103135866,278145,6690296,96100,2575331282
2010-09-13,71,2621304462,192569363,257645,6631071,9700,2627935533
2010-09-14,70,2618194471,122089778,201445,5944824,32200,2624139295
2010-09-15,69,2614204191,128825123,196745,5674825,17600,2619879016
2010-09-16,68,2631809132,129223608,204045,5954733,33100,2637763865
2010-09-17,67,2668066420,117420810,206545,5944573,30600,2674010993
2010-09-20,66,2736068769,127859806,233945,6277730,48100,2742346499
2010-09-21,65,2724501690,73780692,233745,6292451,15500,2730794141
2010-09-27,64,2778508977,162672915,214245,5760387,4500,2784269364
2010-09-28,63,2795750305,142460313,206845,5524300,1200,2801274605
2010-09-29,62,2821582317,163401189,182345,4995213,26200,2826577530
2010-09-30,61,2846908595,230489640,187545,5757722,50300,2852666317
2010-10-08,60,2879844623,352236845,251233,8043235,116900,2887887858
2010-10-11,59,2854342169,540431173,397333,11346296,234200,2865688465
2010-10-12,58,2911633870,466185821,465533,12313951,123100,2923947821
2010-10-13,57,2945491873,511670532,739533,15999257,387000,2961491130
2010-10-14,56,3012610812,643408502,1183133,22358972,645300,3034969784
2010-10-15,55,3074262298,763331295,1124694,20101316,669000,3094363614
2010-10-18,54,3152329327,777043254,940407,17962007,285274,3170291334
2010-10-19,53,3288583583,556393938,928137,19002447,203621,3307586030
2010-10-20,52,3449163925,748459214,933337,21142887,194000,3470306812
2010-10-21,51,3596853448,449387902,677432,18477168,91500,3615330616
2010-10-22,50,3755121466,479643761,475332,15181865,41300,3770303331
2010-10-25,49,3936580107,738284867,486332,15947408,88900,3952527515
2010-10-26,48,4071030302,659869062,642432,16896360,311600,4087926662
2010-10-27,47,4269896802,614699304,563562,13273825,427230,4283170627
2010-10-28,46,4324880974,447080074,558536,11504878,307300,4336385852
2010-10-29,45,4296990516,459821357,399600,8471305,245900,4305461821
2010-11-01,44,4341749551,498627782,491400,10079811,200210,4351829362
2010-11-02,43,4470409233,771255747,393200,8514685,498653,4478923918
2010-11-03,42,4579337355,644200987,540018,10323308,328300,4589660663
2010-11-04,41,4687431943,616399880,608489,11538012,370710,4698969955
2010-11-05,40,4878634897,845292430,610189,12221523,147200,4890856420
2010-11-08,39,5205338554,747835334,690318,12687718,321475,5218026272
2010-11-09,38,5427122250,673362671,496500,8898349,238736,5436020599
2010-11-10,37,5669380056,742219805,376923,9812493,146123,5679192549
2010-11-11,36,5772737492,808783051,393223,8561789,225200,5781299281
2010-11-12,35,5535208139,697482878,422600,6708001,586997,5541916140
2010-11-15,34,5777852641,640509031,346400,5068891,191576,5782921532
2010-11-16,33,5759550131,502106601,188608,2722873,279700,5762273004
2010-11-17,32,5816759463,492329349,340200,4704616,387448,5821464079
2010-11-18,31,5825398138,358203003,272732,3358346,254548,5828756484
2010-11-19,30,5603612499,307385398,453648,5957617,358538,5609570116
2010-11-22,29,5719559877,469767361,372748,4784637,80200,5724344514
2010-11-23,28,5739500620,287201446,514748,7526229,229000,5747026849
2010-11-24,27,5822662043,435812235,417648,5899263,97800,5828561306
2010-11-25,26,5970633357,554239093,533304,8944840,191600,5979578197
2010-11-26,25,5903402929,329668655,514357,7255734,440380,5910658663
2010-11-29,24,5929259556,293264104,1809826,12689598,1604077,5941949154
2010-11-30,23,5936566231,372617460,1820641,13391922,757715,5949958153
2010-12-01,22,5937744337,263690928,1900828,13522674,544289,5951267011
2010-12-02,21,5997821790,308030176,1913976,14683623,517948,6012505413
2010-12-03,20,6090572316,329387031,1749408,13480634,317400,6104052950
2010-12-06,19,6164097438,382055879,464227,7827321,430100,6171924759
2010-12-07,18,6265658521,452005783,391987,6328242,708000,6271986763
2010-12-08,17,6287597522,397789735,394437,4904499,452850,6292502021
2010-12-09,16,6527614801,590322354,621644,6716150,648581,6534330951
2010-12-10,15,6644591506,385958637,409938,5320758,604287,6649912264
2010-12-13,14,7209404871,1038828767,841438,11021133,1088500,7220426004
2010-12-14,13,7373777616,598845377,1274597,12452885,1185359,7386230501
2010-12-15,12,7462794030,542387127,539843,7096652,646067,7469890682
2010-12-16,11,7542711921,448723342,506199,6987252,621900,7549699173
2010-12-17,10,7493201511,245814175,307505,3888480,436200,7497089991
2010-12-20,9,7435701311,396781734,872930,9139721,1300196,7444841032
2010-12-21,8,7564667757,622556317,550844,7898275,757944,7572566032
2010-12-22,7,7776178311,569147197,384706,4995923,627562,7781174234
2010-12-23,6,7817500749,375027731,659106,8295867,725400,7825796616
2010-12-24,5,7897318010,392595142,432130,5257608,430600,7902575618
2010-12-27,4,7980334051,568941962,642745,7669058,1192141,7988003109
2010-12-28,3,8010109091,405320013,269648,5729010,674382,8015838101
2010-12-29,2,8146359995,351203051,271488,5575964,353640,8151935959
2010-12-30,1,8220105721,373192568,370068,6870974,913880,8226976695
2010-12-31,0,8427486678,601063229,196184,4103136,364366,8431589814
2011-01-04,243,8516136811,727620536,437889,6276423,564533,8522413234
2011-01-05,242,8596471915,631058464,292089,3737827,274600,8600209742
2011-01-06,241,8727223150,509404270,326823,4413921,377620,8731637071
2011-01-07,240,8690038014,626845747,690326,9286568,1202003,8699324582
2011-01-10,239,8758781466,560718946,550461,6997014,546062,8765778480
2011-01-11,238,8667104852,355611110,897535,10944904,708474,8678049756
2011-01-12,237,8710801634,401466452,854548,10147082,571040,8720948716
2011-01-13,236,8754029313,367484313,781358,11325427,249101,8765354740
2011-01-14,235,8769493796,379638726,702858,6913532,423910,8776407328
2011-01-17,234,8821400941,443218144,809973,7448751,840392,8828849692
2011-01-18,233,8981757570,405004924,588226,5909762,515500,8987667332
2011-01-19,232,9087977825,462920729,555611,7280845,532300,9095258670
2011-01-20,231,9086647897,497827964,456911,6614513,591600,9093262410
2011-01-21,230,9102872273,540497532,554580,7299859,1357900,9110172132
2011-01-24,229,9177837418,509692127,896102,9228124,1250571,9187065542
2011-01-25,228,9220062356,346162375,689771,9333398,361280,9229395754
2011-01-26,227,9349795135,389519420,808236,9365923,544400,9359161058
2011-01-27,226,9429095585,695694010,1315956,12945773,1377700,9442041358
2011-01-28,225,9469502833,447644390,1277756,12840273,515000,9482343106
2011-01-31,224,9583910868,632364871,1528405,15715553,989600,9599626421
2011-02-01,223,9402454012,392394929,961205,12960401,673100,9415414413
2011-02-09,222,9589509907,529461387,999913,12714493,858828,9602224400
2011-02-10,221,9740914093,491495815,1092573,13778369,430809,9754692462
2011-02-11,220,9771176484,512505121,863773,10218163,183570,9781394647
2011-02-14,219,9715701377,915382728,1398773,17152769,895000,9732854146
2011-02-15,218,9596234682,860216663,1274273,14779112,730800,9611013794
2011-02-16,217,9792654830,847457177,1199053,13686326,377000,9806341156
2011-02-17,216,10032421759,955054160,1174063,12102813,586242,10044524572
2011-02-18,215,10157728964,647287468,1139340,11894180,517100,10169623144
2011-02-21,214,10315577822,767670898,1020144,11621281,647958,10327199103
2011-02-22,213,10525272993,1001895274,1431301,15915330,1988907,10541188323
2011-02-23,212,10619583455,647426365,972043,14897624,1245891,10634481079
2011-02-24,211,10796619793,794570977,1308597,17262748,1806055,10813882541
2011-02-25,210,10858082464,692267202,932791,16338957,1283484,10874421421
2011-02-28,209,10886936320,675667868,1156621,17100603,1615160,10904036923
2011-03-01,208,10924143093,769595277,1498840,22389292,1456341,10946532385
2011-03-02,207,11009415972,808798087,1761509,23705832,1752220,11033121804
2011-03-03,206,11046130055,1019788440,4413327,57169330,4624908,11103299385
2011-03-04,205,11147027377,747928982,3154893,45941862,2749980,11192969239
2011-03-07,204,11378560775,1337038695,4776797,77652784,3075421,11456213559
2011-03-08,203,11521780981,904709041,4265229,71401857,1756246,11593182838
2011-03-09,202,11615540852,801429978,4563041,75334080,2824714,11690874932
2011-03-10,201,11749387072,849626386,3864903,55875733,1989364,11805262805
2011-03-11,200,11973484849,745190335,3072279,41932876,1026502,12015417725
2011-03-14,199,12144451877,557513061,2278770,35723632,462300,12180175509
2011-03-15,198,12234504116,911628602,3187169,53807370,2658107,12288311486
2011-03-16,197,12214737047,892411036,4176678,60619177,2859423,12275356224
2011-03-17,196,12128220239,761298186,3190921,55122334,2079084,12183342573
2011-03-18,195,12177302266,573637847,2822995,52352121,644890,12229654387
2011-03-21,194,12286615929,663574647,3119346,53508592,1095180,12340124521
2011-03-22,193,12389914708,611897421,4029430,66353212,2623142,12456267920
2011-03-23,192,12473138104,784408790,3867230,62197982,1280206,12535336086
2011-03-24,191,12569889147,652630190,3981062,68362920,1179932,12638252067
2011-03-25,190,12645793482,872828184,3599329,58416102,2152467,12704209584
2011-03-28,189,12747132404,1099208957,3649954,49224109,2724000,12796356513
2011-03-29,188,13000571572,1392433791,7308035,84735680,6399488,13085307252
2011-03-30,187,13114336973,971615362,5501314,68312126,3531533,13182649099
2011-03-31,186,13389814034,957692779,5412348,62935430,4025546,13452749464
2011-04-01,185,13397963410,926784061,5728654,63330615,4045524,13461294025
2011-04-06,184,13311929130,1453562222,9962181,116722118,5630068,13428651248
2011-04-07,183,13456816257,1083025717,9643279,114503907,2837584,13571320164
2011-04-08,182,13663436042,987464836,7076922,90126072,1459031,13753562114
2011-04-11,181,14042989427,1624611942,7216389,91166318,2178560,14134155745
2011-04-12,180,14507155762,1382760835,8994317,89657042,5225243,14596812804
2011-04-13,179,14822054819,1279809135,5703039,79253489,1932786,14901308308
2011-04-14,178,14893886634,1055293369,6117783,77139044,2627953,14971025678
2011-04-15,177,14964312035,907993468,7011864,79992980,4872515,15044305015
2011-04-18,176,15115565632,1078745597,7706571,81851545,3249509,15197417177
2011-04-19,175,15113883362,833387870,6761054,71154456,2117258,15185037818
2011-04-20,174,15422476966,974222845,5668500,66104465,3303600,15488581431
2011-04-21,173,15678896887,891476736,6904789,74874951,3852804,15753771838
2011-04-22,172,15747595484,793020974,6733335,73647335,2122066,15821242819
2011-04-25,171,15674614639,831491973,10324778,88110797,6829894,15762725436
2011-04-26,170,15631632543,607506192,9058682,81107842,2767526,15712740385
2011-04-27,169,15650190523,700835759,6616761,70066258,2820572,15720256781
2011-04-28,168,15496163903,816293853,6300953,69131777,3717515,15565295680
2011-04-29,167,15489352748,660353548,7108920,77939727,5409610,15567292475
2011-05-03,166,15460738148,576526525,8520054,79822417,4452343,15540560565
2011-05-04,165,15343903210,720446025,9876674,90450206,6684147,15434353416
2011-05-05,164,15244339467,517842819,8093045,74631038,4013594,15318970505
2011-05-06,163,15121981644,575024359,7884402,79037225,3168270,15201018869
2011-05-09,162,15232374677,655677577,6954166,79239553,3053830,15311614230
2011-05-10,161,15395985663,549641025,8506550,95339354,4009762,15491325017
2011-05-11,160,15401083312,446166522,6848453,84911516,2034728,15485994828
2011-05-12,159,15577419319,637723841,7396415,79021693,2865176,15656441012
2011-05-13,158,15708129071,839978633,5952900,77440669,2347153,15785569740
2011-05-16,157,15719819800,429035133,5888151,77105086,1494117,15796924886
2011-05-17,156,15929011870,531243729,6135784,77901100,3172339,16006912970
2011-05-18,155,16108290447,488478494,5823070,76216406,1213983,16184506853
2011-05-19,154,16077648730,457940932,6641537,87460100,2057864,16165108830
2011-05-20,153,16152695129,388182430,5823957,83657525,1343500,16236352654
2011-05-23,152,16098875769,583648042,4944670,71963942,1974913,16170839711
2011-05-24,151,16214417437,435565589,5842578,81266047,2168465,16295683484
2011-05-25,150,16283881810,452351034,6097604,79638143,2105200,16363519953
2011-05-26,149,16341680214,355960669,6033407,78006622,2108777,16419686836
2011-05-27,148,16191808615,353444434,5550782,72613616,3297768,16264422231
2011-05-30,147,16213113108,405172307,6559796,81285713,2173872,16294398821
2011-05-31,146,16438326942,605991887,6405088,82236507,2723857,16520563449
2011-06-01,145,16497676967,429816133,5753115,86503868,1261193,16584180835
2011-06-02,144,16686353331,707660792,4478362,71607044,2568570,16757960375
2011-06-03,143,16651911918,429223785,4572371,69985984,1436302,16721897902
2011-06-07,142,16632529204,494847936,4933489,71988989,1125846,16704518193
2011-06-08,141,16637485175,652215529,5936404,82207141,2297381,16719692316
2011-06-09,140,16652969254,536559008,5502362,77298236,1354205,16730267490
2011-06-10,139,16706872250,510782266,6829387,87414402,3503615,16794286652
2011-06-13,138,16526574094,461222722,7313918,89785589,2794483,16616359683
2011-06-14,137,16495870887,632876203,7462570,96724997,4647154,16592595884
2011-06-15,136,16604120197,681522651,7176378,92799285,2954550,16696919482
2011-06-16,135,16725857941,548958255,6380948,80625517,3149921,16806483458
2011-06-17,134,15996336369,543788365,6893626,85261149,3206708,16081597518
2011-06-20,133,16237528175,684553790,7041289,84482812,4208224,16322010987
2011-06-21,132,16298026991,556172998,8746775,108578882,4500981,16406605873
2011-06-22,131,16340605968,458576650,8562699,110372758,3246944,16450978726
2011-06-23,130,16344099381,590474443,10385270,127163624,5572437,16471263005
2011-06-24,129,16292288301,1246001461,12614137,139250514,7404590,16431538815
2011-06-27,128,16488029126,875088965,11729864,136963765,3819564,16624992891
2011-06-28,127,16606989920,808099694,12446374,140407937,5449689,16747397857
2011-06-29,126,16809796611,858850391,11266552,120598921,4031312,16930395532
2011-06-30,125,17124281108,1040052866,11193673,131300405,5586823,17255581513
2011-07-01,124,17284258925,924432426,9895063,126466709,3314300,17410725634
2011-07-04,123,17323611660,1166307857,12854616,152657402,5022068,17476269062
2011-07-05,122,17383762436,922968515,11443964,138735839,4495776,17522498275
2011-07-06,121,17663982481,986207992,8978645,120444365,2794260,17784426846
2011-07-07,120,17758752144,1120177136,10090018,128926937,5285068,17887679081
2011-07-08,119,17776243573,836312390,9576651,123145684,3327510,17899389257
2011-07-11,118,17917092953,703189744,9106733,120987808,2281816,18038080761
2011-07-12,117,17997153779,882517355,7666637,96865179,1397483,18094018958
2011-07-13,116,18208652416,810911250,8339733,107247652,4194816,18315900068
2011-07-14,115,18255187388,941410724,10004823,118056602,7088673,18373243990
2011-07-15,114,18253511171,898096392,11091762,124866183,4445765,18378377354
2011-07-18,113,18533214237,938114982,10626146,118284743,4400937,18651498980
2011-07-19,112,18721052787,869512293,9226150,116105702,4966708,18837158489
2011-07-20,111,18904053734,753245170,8025978,104270653,2273105,19008324387
2011-07-21,110,19064469706,794485438,7927616,103321745,2763768,19167791451
2011-07-22,109,19089884281,538622268,8038123,109482316,2046281,19199366597
2011-07-25,108,19407400892,1223685970,7053850,90912525,5661279,19498313417
2011-07-26,107,19521197009,600132078,6979343,91989898,4838398,19613186907
2011-07-27,106,19723552899,710416333,7058607,91618285,4154342,19815171184
2011-07-28,105,19687768485,729220145,6158003,89444658,2856995,19777213143
2011-07-29,104,19559824766,599191915,7444958,99044215,7700455,19658868981
2011-08-01,103,19710659516,526493233,6757289,94262148,3564907,19804921664
2011-08-02,102,19875147783,587232237,5634766,80459862,3827179,19955607645
2011-08-03,101,19947338610,517125110,6009484,84927100,2512125,20032265710
2011-08-04,100,19916978654,425657196,6177709,88632479,1934766,20005611133
2011-08-05,99,19903220315,732342442,6236968,81846166,4610775,19985066481
2011-08-08,98,19965951464,1069167394,6228649,84548175,6829971,20050499639
2011-08-09,97,19958893276,928507380,8510822,103220280,9821263,20062113556
2011-08-10,96,19891797252,722853204,8164476,102750046,6358839,19994547298
2011-08-11,95,19853845619,734314619,10015140,118858307,9749563,19972703926
2011-08-12,94,19780555772,613786247,8721815,100761200,5604528,19881316972
2011-08-15,93,19900155759,753176441,12740168,138610368,7811496,20038766127
2011-08-16,92,19938522613,667246061,11029909,119343076,5334915,20057865689
2011-08-17,91,20020240955,543389929,11401958,121490686,5960696,20141731641
2011-08-18,90,20125765773,551565624,9341227,102841701,2849491,20228607474
2011-08-19,89,20074117205,651203376,9616532,105792568,5616951,20179909773
2011-08-22,88,20104631668,558701490,9545426,105877958,3715579,20210509626
2011-08-23,87,20161763673,533358619,10029143,119578438,5461264,20281342111
2011-08-24,86,20148223867,612218009,10600253,124292110,4595203,20272515977
2011-08-25,85,19909811437,1096244617,18118303,178337878,19696022,20088149315
2011-08-26,84,20109341830,779339684,14260666,144852223,4749623,20254194053
2011-08-29,83,20496342307,924883740,14198005,138195444,6936504,20634537751
2011-08-30,82,20749898186,941988987,15575374,144874603,8519795,20894772789
2011-08-31,81,20893312611,631883913,14817593,156151205,5352129,21049463816
2011-09-01,80,20898889032,591419508,16459049,170124255,6978877,21069013287
2011-09-02,79,20901163881,513088861,15842578,148371813,4677930,21049535694
2011-09-05,78,21003486998,544363500,15756419,151286436,4891217,21154773434
2011-09-06,77,21068944086,538935703,15441020,140792805,6705595,21209736891
2011-09-07,76,21042304936,545203523,13341862,137647700,7934344,21179952636
2011-09-08,75,21114896834,426969613,11230126,119523196,2851131,21234420030
2011-09-09,74,21041870266,456447707,11242329,123040515,4718266,21164910781
2011-09-13,73,21122136936,496754054,13236777,135897276,5736074,21258034212
2011-09-14,72,21050929175,578762129,13571790,141502534,8655411,21192431709
2011-09-15,71,20996390466,520749456,15301780,153849633,6723858,21150240099
2011-09-16,70,21020934154,481260309,14739963,152059454,3733105,21172993608
2011-09-19,69,21103835093,477718941,15411506,149393710,5293501,21253228803
2011-09-20,68,21181592617,498228852,14239386,143514609,5818837,21325107226
2011-09-21,67,21080852830,954136977,21524918,206591595,12898976,21287444425
2011-09-22,66,21403223921,1069294786,14441300,130053405,4620321,21533277326
2011-09-23,65,21359329274,725289704,13089962,120866382,8825812,21480195656
2011-09-26,64,21304984798,770319061,14219544,139292010,10197700,21444276808
2011-09-27,63,21442994144,798225193,13724995,137037016,8993687,21580031160
2011-09-28,62,21285200989,589898985,14122313,138656353,8666246,21423857342
2011-09-29,61,21137792643,607797098,11299531,114029122,8060878,21251821765
2011-09-30,60,20678257223,492770036,10440824,103619722,5937150,20781876945
2011-10-10,59,20500158665,563518759,13608090,127729044,6471754,20627887709
2011-10-11,58,20324309699,818716848,16966515,164383113,14579542,20488692812
2011-10-12,57,20430753257,1268675776,20463760,197808881,17590680,20628562138
2011-10-13,56,20543903238,1004156009,19387268,189604710,10184680,20733507948
2011-10-14,55,20400802814,566964409,18130701,173236358,7224172,20574039172
2011-10-17,54,20300361995,615448397,22424092,224636776,9809467,20524998771
2011-10-18,53,20246908676,767490712,20821522,201356530,9000481,20448265206
2011-10-19,52,20242841224,560816548,21272854,214840500,9326280,20457681724
2011-10-20,51,20274135425,763089420,19965227,202598780,12806994,20476734205
2011-10-21,50,20077609862,435631187,21500417,211420624,8870038,20289030486
2011-10-24,49,19813181984,665327297,29481990,277010395,16458480,20090192379
2011-10-25,48,19857163052,1013477891,27805778,275098742,11529889,20132261794
2011-10-26,47,19786668727,1186801201,25867196,278027139,11895931,20064695866
2011-10-27,46,19930731684,866055881,25870085,269320285,8478125,20200051969
2011-10-28,45,19749284408,1317088917,24563599,280412541,14722998,20029696949
2011-10-31,44,19901349449,848254260,28142824,289607069,12563771,20190956518
2011-11-01,43,20008002941,1034962228,26987151,311177544,13416001,20319180485
2011-11-02,42,20094724795,1186052906,29986982,324025976,16013940,20418750771
2011-11-03,41,20365235328,1715745986,31206137,350922118,12683294,20716157446
2011-11-04,40,20425574366,1033452397,26947593,313367437,8369940,20738941803
2011-11-07,39,20693207005,948486415,26955213,291959397,9635057,20985166402
2011-11-08,38,20904972932,899090697,26772166,282879218,10627240,21187852150
2011-11-09,37,21137377041,941665090,26167383,274341766,9004068,21411718807
2011-11-10,36,21382370001,988495911,24396868,251366496,8554810,21633736497
2011-11-11,35,21345143945,522265203,21814465,228553808,6117291,21573697753
2011-11-14,34,21472109836,975365770,26773711,283122754,10944894,21755232590
2011-11-15,33,21642895602,779370039,27080435,273247991,7269674,21916143593
2011-11-16,32,22079287311,1219956202,26259470,239721422,9295086,22319008733
2011-11-17,31,22110549167,648788840,26273433,227849268,7134576,22338398435
2011-11-18,30,22128264632,780915845,24522714,222239814,10335910,22350504446
2011-11-21,29,22261866663,559758089,22621233,199896201,6876944,22461762864
2011-11-22,28,22340596474,525422181,25818227,222145112,10996422,22562741586
2011-11-23,27,22381342035,531977490,25511851,226185197,7883063,22607527232
2011-11-24,26,22421973306,533808677,26046976,222336516,10427210,22644309822
2011-11-25,25,22400850427,378427898,24411174,229398872,6142342,22630249299
2011-11-28,24,22494897616,416782437,23766060,237443922,8508862,22732341538
2011-11-29,23,22518644243,523651456,23939304,243157210,6499083,22761801453
2011-11-30,22,22466452028,671042821,25789420,251839752,13718818,22718291780
2011-12-01,21,22299466764,1146806646,31414320,323600241,23831887,22623067005
2011-12-02,20,22267766625,591659988,25798251,286192505,11811426,22553959130
2011-12-05,19,22379650562,875782534,28770860,285651059,11485770,22665301621
2011-12-06,18,22413359472,596412942,30294629,323513134,12894247,22736872606
2011-12-07,17,22449261088,604856537,32517630,355100811,12002880,22804361899
2011-12-08,16,22528992922,675914693,31650642,348107592,13511857,22877100514
2011-12-09,15,22507138358,566831017,31101894,331965565,12314384,22839103923
2011-12-12,14,22525065787,554603321,33629217,347531224,14426092,22872597011
2011-12-13,13,22643584951,833397363,32193838,307393822,18470026,22950978773
2011-12-14,12,22710676753,632941142,35419573,330633736,18636350,23041310489
2011-12-15,11,22829426940,963186538,28592270,272303088,21056484,23101730028
2011-12-16,10,22960970432,860810024,30758385,305995652,21208854,23266966084
2011-12-19,9,23160945470,822981905,33105978,332957773,24292388,23493903243
2011-12-20,8,23215304975,728256469,34861389,360845947,15958852,23576150922
2011-12-21,7,23213182571,747255578,37184408,377163348,20155441,23590345919
2011-12-22,6,23156209497,712315873,37859438,379727180,25005463,23535936677
2011-12-23,5,23022628028,606711079,37405942,376194331,23217806,23398822359
2011-12-26,4,23097117469,581463956,44732221,416766360,25980338,23513883829
2011-12-27,3,23125457645,595501546,42098722,404473909,22763301,23529931554
2011-12-28,2,23227075749,640946990,39661774,363621020,26680606,23590696769
2011-12-29,1,23261484479,635606065,41815062,376407550,20787029,23637892029
2011-12-30,0,23163493473,762689122,42775775,381308271,16111293,23544801744
2012-01-04,242,23086161879,788064877,46400139,420191819,23909849,23506353698
2012-01-05,241,22871007499,794286091,50717382,442507556,33093226,23313515055
2012-01-06,240,22974795499,825709884,46360925,424102079,28232074,23398897578
2012-01-09,239,22853440665,1130784004,53940103,493659623,36755697,23347100288
2012-01-10,238,22773950655,1701133654,60754782,542466054,36201132,23316416709
2012-01-11,237,22869720240,1274706955,54570044,484380898,22465195,23354101138
2012-01-12,236,22781226572,1231619261,55347593,518981025,25652667,23300207597
2012-01-13,235,22674391245,1133649934,53783886,472373707,32020707,23146764952
2012-01-16,234,22638911372,878056969,55948078,482314622,23390485,23121225994
2012-01-17,233,22582606058,1651314781,58887823,472151600,44605354,23054757658
2012-01-18,232,22564638461,1581544852,58523016,462490757,27677343,23027129218
2012-01-19,231,22161798417,1384432993,55687161,469400533,34258703,22631198950
2012-01-20,230,21088647331,1142179973,55586416,465817218,26347917,21554464549
2012-01-30,229,21653344631,1502767818,61608639,517342115,27449182,22170686746
2012-01-31,228,22014346641,1044338505,65089079,516870389,25851288,22531217030
2012-02-01,227,22366485298,1285617462,62171415,499224550,29621146,22865709848
2012-02-02,226,22396236472,1178861936,74944712,616095248,40883119,23012331720
2012-02-03,225,22515446802,1520410924,72249383,614937122,28466238,23130383924
2012-02-06,224,22784517940,1343935156,79203248,647383244,30082272,23431901184
2012-02-07,223,23313248252,1445701790,67519882,547716962,23234560,23860965214
2012-02-08,222,23304347745,1565565996,76405228,626032158,42850739,23930379903
2012-02-09,221,23364280534,1737119914,73917036,614904727,24235925,23979185261
2012-02-10,220,23186699954,1445006748,77934173,644878993,37539934,23831578947
2012-02-13,219,23608213305,1582126178,74001887,607362447,27428688,24215575752
2012-02-14,218,23860965648,1256560815,67425776,579118989,21818417,24440084637
2012-02-15,217,24179753364,1781362196,70206203,601734232,33021804,24781487596
2012-02-16,216,24491754154,1582477398,67354573,590145157,29591666,25081899311
2012-02-17,215,24478237341,1179539111,67342330,576582374,21536477,25054819715
2012-02-20,214,24772829932,1759766700,67006375,579980747,25030078,25352810679
2012-02-21,213,24969797018,1563224989,67474234,604735691,28384179,25574532709
2012-02-22,212,25223728541,2434752756,71213515,648311438,33399169,25872039979
2012-02-23,211,25509973452,2185981378,74545206,658672185,29827061,26168645637
2012-02-24,210,25607219924,2713861391,79216645,715901888,38356889,26323121812
2012-02-27,209,25953096751,3344833427,84073278,749953321,40228327,26703050072
2012-02-28,208,26173607268,2196625510,87665091,723104224,35380084,26896711492
2012-02-29,207,26421186475,2001683188,69376741,618905567,21241505,27040092042
2012-03-01,206,26693098407,1544104350,66158703,599587277,18384913,27292685684
2012-03-02,205,27048735068,2290381860,68726983,651310699,32257235,27700045767
2012-03-05,204,27545673775,2328139500,69480404,661468241,23245402,28207142016
2012-03-06,203,27925437822,2260379699,57613626,576731626,22969708,28502169448
2012-03-07,202,28322835473,2037715180,60969711,572080706,27513496,28894916179
2012-03-08,201,28553279578,2004963445,65148944,617717954,30877433,29170997532
2012-03-09,200,28698907823,2039557422,68860749,627719200,27333645,29326627023
2012-03-12,199,29313541336,2466695709,67451971,624485011,21119382,29938026347
2012-03-13,198,29506123404,2090953160,69587560,650512180,26611167,30156635584
2012-03-14,197,29962495014,3971920425,69025989,583607249,49997459,30546102263
2012-03-15,196,30030622336,2615937639,59941649,553397981,32707021,30584020317
2012-03-16,195,30040251162,1990283308,54580030,560756438,28742946,30601007600
2012-03-19,194,30589579776,2323158537,56181903,578814778,27401075,31168394554
2012-03-20,193,30881415456,2213237546,56871972,538233515,30913007,31419648971
2012-03-21,192,31184318827,2250811673,54813928,524894386,35619553,31709213213
2012-03-22,191,31258610141,1552432938,57970650,539410434,31317968,31798020575
2012-03-23,190,31324525878,1588669351,48785242,501264079,26483738,31825789957
2012-03-26,189,31310255462,1024520698,46497850,500457946,23866413,31810713408
2012-03-27,188,31652995174,1639570640,49559003,506940846,27388022,32159936020
2012-03-28,187,31725359177,1803704771,48674164,472971028,42376494,32198330205
2012-03-29,186,31466692094,1468201404,44127042,451280109,46667617,31917972203
2012-03-30,185,30855059829,1118746389,56193346,498505368,62941195,31353565197
2012-04-05,184,31036889547,1910713961,64586644,612979847,56598239,31649869394
2012-04-06,183,31203189503,1556670352,73395741,638010186,46986690,31841199689
2012-04-09,182,31312683905,1263660302,68770210,637822011,47806726,31950505916
2012-04-10,181,31315108010,1442581118,73810230,613613548,80355809,31928721558
2012-04-11,180,31650530805,1620531132,79068442,637539984,55313390,32288070789
2012-04-12,179,31658371384,2069068142,99941076,728861977,80194978,32387233361
2012-04-13,178,31321457781,1929005224,103454520,724919491,42290928,32046377272
2012-04-16,177,31551930384,1690206798,99357507,745742224,40483930,32297672608
2012-04-17,176,31701763328,1522188706,75021384,644509653,28548563,32346272981
2012-04-18,175,31713063485,2056222445,94973520,742347355,68153995,32455410840
2012-04-19,174,31763708953,2086454193,95252379,745588191,36252010,32509297144
2012-04-20,173,31697962487,2307629393,107583581,799575812,65626841,32497538299
2012-04-23,172,31919290664,2418725607,93581898,740475666,33113154,32659766330
2012-04-24,171,31886526859,2842912506,89615736,698699325,100606915,32585226184
2012-04-25,170,32022808570,2546857177,95956860,733448615,77263596,32756257185
2012-04-26,169,32207563433,2491763979,92790440,711808798,61307519,32919372231
2012-04-27,168,31996092316,1870375931,75102834,652371267,44197746,32648463583
2012-05-02,167,32374252299,3738262191,102616917,762654074,96784966,33136906373
2012-05-03,166,32914444024,2695216589,100602257,797696945,55100759,33712140969
2012-05-04,165,32929079712,2390138078,94427325,793584355,44620428,33722664067
2012-05-07,164,33467500884,2716734348,93667450,728200355,47121086,34195701239
2012-05-08,163,33893622504,2441135022,89363763,722745535,46747769,34616368039
2012-05-09,162,34451948648,2651766271,70429182,625816606,31970137,35077765254
2012-05-10,161,35040860645,2161721639,70736344,622693679,46438814,35663554324
2012-05-11,160,35115705765,1960511506,72634354,618124665,52964430,35733830430
2012-05-14,159,35628803242,2461641937,83330079,626430094,58276789,36255233336
2012-05-15,158,36152562663,2036097511,76164785,655470335,44423368,36808032998
2012-05-16,157,36779217694,2178812217,82716723,646127083,54455563,37425344777
2012-05-17,156,36787680964,1962619901,98072503,715905627,72488823,37503586591
2012-05-18,155,36821357488,1888308119,79483011,650247666,48150091,37471605154
2012-05-21,154,37126490787,1797956959,79977463,691025268,70327136,37817516055
2012-05-22,153,37079833553,1671466540,101272872,792549634,62123968,37872383187
2012-05-23,152,37072055664,1835455665,110405609,851734986,63951152,37923790650
2012-05-24,151,37528312047,1988441593,109119638,814032820,48564343,38342344867
2012-05-25,150,37535963602,1497066380,99344339,770189440,65466655,38306153042
2012-05-28,149,37598761062,1930551399,100085549,770434631,79788676,38369195693
2012-05-29,148,37676358273,2823201360,102682123,795978999,85831190,38472337272
2012-05-30,147,37985520066,2248621352,96936518,837500845,56907028,38823020911
2012-05-31,146,38363704389,2037759682,81459868,762840548,41239991,39126544937
2012-06-01,145,38393016442,1909782134,82324321,741659426,48880185,39134675868
2012-06-04,144,39201386102,2785005768,70592507,674920254,46517920,39876306356
2012-06-05,143,39341792121,1627172086,79361897,693111890,72500316,40034904011
2012-06-06,142,39585278444,1698621302,75901796,696908292,55559875,40282186736
2012-06-07,141,39824344326,1889737375,80374882,693817796,55219901,40518162122
2012-06-08,140,39719820736,1805598796,74578434,707825275,68552372,40427646011
2012-06-11,139,39915091233,1777895999,71278581,708140329,69193516,40623231562
2012-06-12,138,40118853209,1626998751,86829122,775286155,86560332,40894139364
2012-06-13,137,40366154559,2136093851,88006249,804450614,75040967,41170605173
2012-06-14,136,40463725268,1596178919,91731657,805817964,63646404,41269543232
2012-06-15,135,40424538156,2362756170,76271115,752573261,61302167,41177111417
2012-06-18,134,40774082626,1739591533,82028223,785854699,53460264,41559937325
2012-06-19,133,40959301472,1610403138,83848906,737452012,50150367,41696753484
2012-06-20,132,40971366211,1305051000,78687462,756005017,32590772,41727371228
2012-06-21,131,41216039765,1827369234,72266373,667886102,58747926,41883925867
2012-06-25,130,41328073117,1688930079,68561048,638598125,50582373,41966671242
2012-06-26,129,41366843299,1329392155,70170803,664880194,55891667,42031723493
2012-06-27,128,41452187393,1170928470,74432399,728466579,47294602,42180653972
2012-06-28,127,41554211158,1419503922,65864694,699842311,41151998,42254053469
2012-06-29,126,41352503305,1575175909,71843529,748286235,55266063,42100789540
2012-07-02,125,41651551679,1764735984,78605198,807498588,57944152,42459050267
2012-07-03,124,41775297474,1608081585,77988261,835347527,60616172,42610645001
2012-07-04,123,41979741991,1502115984,83797944,859659598,54962884,42839401589
2012-07-05,122,41980089686,1357113618,76724103,810716248,45976417,42790805934
2012-07-06,121,42071500783,2161091737,71524787,809180403,55643954,42880681186
2012-07-09,120,42433217425,2200692162,76491434,824026113,65970426,43257243538
2012-07-10,119,42677890401,1526392426,72108460,790231037,51222842,43468121438
2012-07-11,118,42763477754,1400213120,79346065,852955616,55472817,43616433370
2012-07-12,117,42958440250,2685529361,86725318,825305762,81076191,43783746012
2012-07-13,116,42995301769,1496117118,73569060,809010444,57872324,43804312213
2012-07-16,115,42954857532,1612756321,82744142,837478653,63438603,43792336185
2012-07-17,114,42850583006,1320741173,87962716,822312728,78146872,43672895734
2012-07-18,113,43001260903,1706983756,87308300,815806529,94063890,43817067432
2012-07-19,112,43133376716,1899781165,87830435,855940946,101789166,43989317662
2012-07-20,111,43293277130,1377290396,75563457,801988558,81879998,44095265688
2012-07-23,110,43520903617,1270199632,79265046,783217522,74122637,44304121139
2012-07-24,109,43673831708,1164984697,78452436,794241045,74363842,44468072753
2012-07-25,108,43628637939,910461171,77500358,792767238,61189664,44421405177
2012-07-26,107,43605874770,1117458307,81310254,805110770,84741539,44410985540
2012-07-27,106,43546606535,1164631708,82465871,776735174,90590906,44323341709
2012-07-30,105,43600788260,1195213435,82041470,773619516,88269715,44374407776
2012-07-31,104,43397313276,1164959004,87036316,819409782,95425038,44216723058
2012-08-01,103,43473512880,1328778018,87744284,846108824,93231902,44319621704
2012-08-02,102,43560657150,1272423989,109964795,892253942,102298268,44452911092
2012-08-03,101,43644324473,1253402074,86148802,792848081,81031202,44437172554
2012-08-06,100,43983961626,2086998476,82371958,803767457,99916973,44787729083
2012-08-07,99,44381161170,1916815976,76336687,793858759,70258344,45175019929
2012-08-08,98,44382355250,1651113021,81257626,811850790,82835499,45194206040
2012-08-09,97,44655608409,2042616121,80495045,807873776,96060855,45463482185
2012-08-10,96,44448470277,1847683090,74348094,775172979,80525607,45223643256
2012-08-13,95,44805453973,2193592532,72005866,723520744,104164010,45528974717
2012-08-14,94,45090974216,2023420057,72206532,705610508,97420910,45796584724
2012-08-15,93,45370226843,1603184447,72983227,723991809,62266955,46094218652
2012-08-16,92,45507584487,1199331627,69900322,704216605,54400821,46211801092
2012-08-17,91,45527705227,1327191696,69860551,676251541,71407936,46203956768
2012-08-20,90,45688473487,1336773539,70237773,687917590,79200693,46376391077
2012-08-21,89,45866054150,1670213257,78030044,714370674,98054641,46580424824
2012-08-22,88,46048682213,1477904628,75302638,712808353,73249776,46761490566
2012-08-23,87,46197832033,1650535999,84030054,741581199,122034356,46939413232
2012-08-24,86,45979785983,1394092725,74545452,739252012,91369039,46719037995
2012-08-27,85,45733961176,1623650005,84369278,752748959,109171038,46486710135
2012-08-28,84,45822985926,1503902531,101984574,806676314,147566751,46629662240
2012-08-29,83,45764570771,1325562119,90901611,774751600,98202234,46539322371
2012-08-30,82,45665093836,1463049036,87744523,740696134,129610280,46405789970
2012-08-31,81,45671816226,1075961489,84120906,747149759,94804097,46418965985
2012-09-03,80,45954941545,1669079983,90823674,816603315,110289744,46771544860
2012-09-04,79,46165761015,1753553472,91707302,825213972,136972961,46990974987
2012-09-05,78,46434490498,1632564950,94487151,866941167,125504126,47301431665
2012-09-06,77,46734326953,1608727913,101604157,878206655,135899804,47612533608
2012-09-07,76,46551429029,4336815591,126380751,899376929,227423483,47450805958
2012-09-10,75,47126249677,3477138749,119591722,886484812,112440098,48012734489
2012-09-11,74,47897803829,2580282922,110300855,796149061,110351985,48693952890
2012-09-12,73,48462868314,2739662949,101052930,822985772,162310567,49285854086
2012-09-13,72,48798184410,2208340317,96817302,830509365,127242730,49628693775
2012-09-14,71,48670194775,2806237438,98193184,837191615,157294664,49507386390
2012-09-17,70,49040117321,2558273294,94791540,817905616,146148054,49858022937
2012-09-18,69,49256955701,1754116814,81366517,767029684,126572029,50023985385
2012-09-19,68,49533570717,1837774603,86657532,814641345,123927878,50348212062
2012-09-20,67,49793080866,2140705780,87505734,802087336,131210692,50595168202
2012-09-21,66,49751841324,1769209667,85076142,816583676,139891973,50568425000
2012-09-24,65,49922439548,1719001695,87540937,837518922,152475719,50759958470
2012-09-25,64,49668053926,1347716776,90621853,910568341,119230488,50578622267
2012-09-26,63,49560420336,1300488950,93606857,887941875,140129407,50448362211
2012-09-27,62,48907506409,2351994804,107166059,931647214,184576201,49839153623
2012-09-28,61,47592602099,2247164513,101326842,932013450,155872499,48524615549
2012-10-08,60,48264741771,2310097195,119718461,969055748,115648046,49233797519
2012-10-09,59,48396852337,2764492399,133467259,1092153231,146184953,49489005568
2012-10-10,58,48919543554,2279615232,131883103,1073263343,129690882,49992806897
2012-10-11,57,49440483610,2225160985,141203222,1045817724,195813581,50486301334
2012-10-12,56,49448638952,1908823608,129877794,1025770688,156486705,50474409640
2012-10-15,55,49663180778,1691218706,142655629,1090407763,113395044,50753588541
2012-10-16,54,49763747191,1844932312,147389523,1125348375,159267653,50889095566
2012-10-17,53,50073315146,1926672446,156206434,1172942823,153853715,51246257969
2012-10-18,52,49898366599,2447878705,172225102,1258697877,161104011,51157064476
2012-10-19,51,49690327417,1848948756,149291084,1170027001,135684548,50860354418
2012-10-22,50,49878708176,1994060503,164809687,1243452816,139669193,51122160992
2012-10-23,49,50268571335,2284288793,159591985,1165651473,131752963,51434222808
2012-10-24,48,50553991724,1887157124,154386431,1157441737,133866147,51711433461
2012-10-25,47,50925458666,2168295969,146078286,1100159828,139550740,52025618494
2012-10-26,46,51310726506,2288657132,119586704,889943114,111326685,52200669620
2012-10-29,45,51689038799,1584953781,122834403,927847068,128121470,52616885867
2012-10-30,44,51501871483,1589603973,137652090,1001355314,151389572,52503226797
2012-10-31,43,51559113178,1692366022,141296023,1063191973,159333903,52622305151
2012-11-01,42,51237157202,2617929839,159064788,1142165204,186500459,52379322406
2012-11-02,41,51130702397,2343570856,163272076,1181065951,147342085,52311768348
2012-11-05,40,51362279911,2316295635,165124083,1218018631,143928818,52580298542
2012-11-06,39,51683392819,2421704753,159388987,1180023770,166281041,52863416589
2012-11-07,38,51842199361,2051691468,159650300,1198477605,200321673,53040676966
2012-11-08,37,51702911891,2055487490,156054457,1160802573,224975405,52863714464
2012-11-09,36,51496481543,1478652032,158011064,1169277224,207705413,52665758767
2012-11-12,35,51537026715,1767231895,194274310,1292540521,239937283,52829567236
2012-11-13,34,51621569073,1885583091,190958378,1282131180,216004448,52903700253
2012-11-14,33,51742932659,1519967699,193814073,1331110919,272000019,53074043578
2012-11-15,32,51834437830,1585328945,181548847,1291515135,229951784,53125952965
2012-11-16,31,51842436713,1662234177,164870960,1175452798,239594991,53017889511
2012-11-19,30,52136377757,1674655573,166061919,1227615384,252906374,53363993141
2012-11-20,29,52232906651,1509399872,166143592,1208322014,225334923,53441228665
2012-11-21,28,52338359165,1943146103,184856026,1306569346,308581665,53644928511
2012-11-22,27,52326315202,1332145449,172773106,1302639373,214932697,53628954575
2012-11-23,26,52163842479,1543727769,184949966,1347840020,257859771,53511682499
2012-11-26,25,52224867623,1322180521,187498079,1366826765,234474541,53591694388
2012-11-27,24,52059352556,1561381214,195318232,1384086520,255616186,53443439076
2012-11-28,23,51839015969,1430771351,200577797,1363891223,252283104,53202907192
2012-11-29,22,51590830813,1428621103,216979129,1487427984,274952139,53078258797
2012-11-30,21,51380781508,1715103966,213227459,1534954623,272225784,52915736131
2012-12-03,20,50979389957,1746129421,231641500,1642665995,230229452,52622055952
2012-12-04,19,50719310027,1668156873,247998486,1691394679,210297671,52410704706
2012-12-05,18,50824143024,4221718658,260754780,1791669857,342048073,52615812881
2012-12-06,17,51239355809,2710160062,245045308,1773461775,274816420,53012817584
2012-12-07,16,51153092419,3742788183,273389625,1908057633,308254110,53061150052
2012-12-10,15,51306934372,3401162233,313129159,2052661137,312883081,53359595509
2012-12-11,14,51868905998,3125289600,306225400,2031576319,265454958,53900482317
2012-12-12,13,52377520737,2687398378,317828422,2098295346,267006109,54475816083
2012-12-13,12,52669288553,2246499161,288677886,1953468786,217352599,54622757339
2012-12-14,11,52791881649,5843342497,307018627,2087408295,328393870,54879289944
2012-12-17,10,53571995017,5541610549,330016054,2198213076,294180919,55770208093
2012-12-18,9,54408074635,5151252842,337189498,2270274901,300649942,56678349536
2012-12-19,8,54931071842,3768910786,349579396,2273481726,230855261,57204553568
2012-12-20,7,55689600270,4484712392,326438956,2242931415,345922585,57932531685
2012-12-21,6,56447787112,4689255807,307394734,2139542755,269920339,58587329867
2012-12-24,5,57128889679,3788187865,333460818,2257004885,296162726,59385894564
2012-12-25,4,57544359600,6368458672,388333500,2456222039,409792961,60000581639
2012-12-26,3,58354981334,5114111979,376278216,2417109460,234225185,60772090794
2012-12-27,2,59152544022,5373168743,361640747,2353661865,331518088,61506205887
2012-12-28,1,59294670143,5297737080,386182354,2460898300,384019735,61755568443
2012-12-31,0,59014161465,5633864416,490805859,2751605671,407517940,61765767136
2013-01-04,237,60785480318,7407752903,468316259,2811995346,249165702,63597475664
2013-01-07,236,62235629990,5443529030,496273481,2933725931,275217920,65169355921
2013-01-08,235,63304834290,5640074918,470222324,2760964424,228406328,66065798714
2013-01-09,234,64195114532,5722165174,473092376,2728892539,259417409,66924007071
2013-01-10,233,65288113087,5763183125,482789420,2812446464,252995418,68100559551
2013-01-11,232,65761864960,5721944752,428139149,2503842541,229860202,68265707501
2013-01-14,231,66993937995,7911830846,450430887,2776368938,324599804,69770306933
2013-01-15,230,68086057649,7691869725,462407649,2866456375,269803585,70952514024
2013-01-16,229,69257047349,7447346465,427966270,2712346680,234712367,71969394029
2013-01-17,228,70577250953,5886935810,401297868,2549583418,260767601,73126834371
2013-01-18,227,70367079826,5755908405,422240885,2715427584,284914625,73082507410
2013-01-21,226,71876409211,6561602308,467597658,2889135338,280265354,74765544549
2013-01-22,225,73300956177,7837765200,484012406,2877985819,383004646,76178941996
2013-01-23,224,74367360145,5642831418,452815961,2824296289,266353151,77191656434
2013-01-24,223,74826755422,8055560610,443965934,2769072963,363638399,77595828385
2013-01-25,222,74656422784,3835370531,409112298,2643745664,213678710,77300168448
2013-01-28,221,75824006707,7217230263,488530667,3070041858,342789657,78894048565
2013-01-29,220,77370649389,8032156123,524521539,3195250984,324575148,80565900373
2013-01-30,219,79109519537,8022477919,542739932,3231189179,300927152,82340708716
2013-01-31,218,80012584798,7429868873,533770933,3229530293,246998316,83242115091
2013-02-01,217,79974275475,7920561619,520978774,3294340997,285848430,83268616472
2013-02-04,216,82305911782,11251626666,508919726,3224025811,314655291,85529937593
2013-02-05,215,83842570892,9474416050,470151254,3132341883,284032107,86974912775
2013-02-06,214,85266773477,7874045216,455924139,3110879179,206983997,88377652656
2013-02-07,213,86663004886,8580920767,366210902,2660619696,211824227,89323624582
2013-02-08,212,84932368202,6812942439,329320025,2418021962,172759587,87350390164
2013-02-18,211,87926525532,8842693426,335820575,2416617093,205111168,90343142625
2013-02-19,210,89876334442,7886100852,313654098,2271718764,213396088,92148053206
2013-02-20,209,90333744696,6361224934,302836704,2257186074,223244382,92590930770
2013-02-21,208,91468231688,8401141942,249389678,1853586564,262302413,93321818252
2013-02-22,207,91592282645,5317827763,230803646,1742091491,210726317,93334374136
2013-02-25,206,92421928218,4784968168,251500918,1830456434,232553313,94252384652
2013-02-26,205,94033826662,7658469765,239348529,1805074779,286012204,95838901441
2013-02-27,204,94762628748,5775746098,259018993,1840023561,317130058,96602652309
2013-02-28,203,94814148222,7990991763,286756914,2105272544,353484188,96919420766
2013-03-01,202,95606134303,7320602629,262116842,1972673189,263260807,97578807492
2013-03-04,201,97426076304,9066487513,232683604,1727135393,308220189,99153211697
2013-03-05,200,98534885455,8155054783,279817534,2000673735,402108670,100535559190
2013-03-06,199,99945597555,8520559834,299587767,2115377147,327014420,102060974702
2013-03-07,198,101488438654,8464044001,274465533,1966923628,309917753,103455362282
2013-03-08,197,101901925034,5936313125,275907117,1987526048,290445126,103889451082
2013-03-11,196,102821772759,5082088791,267982074,1948452838,276632787,104770225597
2013-03-12,195,102711768682,7022483678,262582542,1902714770,314762594,104614483452
2013-03-13,194,104108557626,5513877779,254251612,1825837512,299097407,105934395138
2013-03-14,193,104874569425,4609782978,286117015,1996905584,283442449,106871475009
2013-03-15,192,105626987105,7471161896,288992367,2011775416,408902401,107638762521
2013-03-18,191,106238513278,5282720607,276039932,2019528889,267797480,108258042167
2013-03-19,190,106755434421,5201097686,291718070,2130073796,289261107,108885508217
2013-03-20,189,107196193138,8066187351,331895869,2399762325,415504328,109595955463
2013-03-21,188,108019003348,7062886655,334857043,2483731778,270158014,110502735126
2013-03-22,187,108591092977,5511652970,318449443,2435871005,243690346,111026963982
2013-03-25,186,109877567428,6297772712,316957896,2449059912,279004940,112326627340
2013-03-26,185,111035476296,7099634360,294171941,2248488085,266674030,113283964381
2013-03-27,184,112137310840,6298683390,291761330,2269197193,267285479,114406508033
2013-03-28,183,113187084739,8010031524,241346363,1899979450,325060876,115087064189
2013-03-29,182,112888053998,5204018492,235085790,1883391009,287753194,114771445007
2013-04-01,181,113635641259,4542232360,236893360,1823593206,232219448,115459234465
2013-04-02,180,114124843819,5298058935,233982688,1812584900,288122642,115937428719
2013-04-03,179,113947874189,4074983283,238181467,1829121676,269389114,115776995865
2013-04-08,178,115054289211,4894186965,231800180,1762793624,298927793,116817082835
2013-04-09,177,115626276701,4952528226,281641041,1985863434,320378225,117612140135
2013-04-10,176,115776352843,4753020947,312303383,2142951912,288025234,117919304755
2013-04-11,175,116103113411,4192362486,316677057,2152973603,201267777,118256087014
2013-04-12,174,115950047834,3905815812,303698649,2148492748,213041967,118098540582
2013-04-15,173,116037778763,4245116922,310449750,2199324054,266042893,118237102817
2013-04-16,172,116263244718,5209405509,296228182,2139946274,307886724,118403190992
2013-04-17,171,117144800742,4875309857,327887516,2267620822,391843539,119412421564
2013-04-18,170,117671674605,4771936720,329887400,2292643432,295537900,119964318037
2013-04-19,169,117698737075,7739024920,352285862,2443084447,412698424,120141821522
2013-04-22,168,119391719252,7099827303,321564829,2384691901,219729253,121776411153
2013-04-23,167,120768319189,7082174321,276912714,2131780731,257901753,122900099920
2013-04-24,166,121552670270,6827152161,301987832,2287185309,379207719,123839855579
2013-04-25,165,122009589488,6886959934,281114391,2172998614,336901479,124182588102
2013-04-26,164,121166321228,5086048547,231242790,1942209657,231262387,123108530885
2013-05-02,163,122197863473,5644481042,256379935,2057674882,262890394,124255538355
2013-05-03,162,121887004198,6620964102,273711623,2148735200,352356561,124035739398
2013-05-06,161,123361128607,7268197122,308417317,2276921533,339490889,125638050140
2013-05-07,160,124270338683,7074720877,329810628,2362140752,303058394,126632479435
2013-05-08,159,124888103709,7157542145,361546449,2507217737,301418246,127395321446
2013-05-09,158,126419196551,8168053782,328586084,2374710357,252690084,128793906908
2013-05-10,157,126740444825,6034576415,302954623,2303727340,290496190,129044172165
2013-05-13,156,128164330004,6459752621,311975510,2360915033,275974650,130525245037
2013-05-14,155,129517780377,6593084766,311169908,2337690202,246497726,131855470579
2013-05-15,154,130323971618,5529182884,337709979,2433053208,254134124,132757024826
2013-05-16,153,131622975578,8878686659,355984760,2475366123,395813111,134098341701
2013-05-17,152,131417103569,8768077046,356603362,2470385623,395353262,133887489192
2013-05-20,151,133091760357,11095254875,346464716,2517281991,375552639,135609042348
2013-05-21,150,134817899289,9591121306,314915983,2334850741,267288382,137152750030
2013-05-22,149,136139858373,9552038138,324325489,2437489139,260782720,138577347512
2013-05-23,148,138316858947,10511455801,310549981,2344207599,314530094,140661066546
2013-05-24,147,138984769078,7928041003,288295711,2234197713,251500832,141218966791
2013-05-27,146,140820346371,9894922165,302399486,2305293833,286551661,143125640204
2013-05-28,145,141777400469,11214809176,327865545,2455374710,457461210,144232775179
2013-05-29,144,143149532749,11029505099,318752046,2456234080,416142975,145605766829
2013-05-30,143,144688843185,10070309550,307986096,2418228409,339229593,147107071594
2013-05-31,142,145252249948,9369266328,283827772,2258880000,359663134,147511129948
2013-06-03,141,147120806309,8694878633,345692219,2557650932,301121296,149678457241
2013-06-04,140,148442795180,8363093077,259566015,2171821367,335833052,150614616547
2013-06-05,139,148965564717,6605148405,249272537,2183048019,237057925,151148612736
2013-06-06,138,149151822571,7577268832,233869034,2071556115,242293234,151223378686
2013-06-07,137,148108787978,7526886429,215926657,1957883747,235243875,150066671725
2013-06-13,136,149005277420,7009864137,236661204,1993164182,332491436,150998441602
2013-06-14,135,148836812594,5797043147,265154999,2061640842,374802575,150898453436
2013-06-17,134,150422821027,6939993912,266931758,2128562400,428371823,152551383427
2013-06-18,133,151212539265,5884392397,301010932,2230422477,477439795,153442961742
2013-06-19,132,152169383198,6713609038,332495342,2207794093,492808671,154377177291
2013-06-20,131,152880634081,6490612227,267805604,1987313226,373385951,154867947307
2013-06-21,130,152615187662,5782677649,239939372,1965173140,486182674,154580360802
2013-06-24,129,150897063226,7735165100,241094775,1790650183,569964484,152687713409
2013-06-25,128,147919911357,8118020855,284873562,1778591939,719022421,149698503296
2013-06-26,127,148060353548,6758398626,324544187,1947125975,593516269,150007479523
2013-06-27,126,146817016731,6272155736,407714571,2249592302,571116427,149066609033
2013-06-28,125,145646592122,6216909816,473465671,2530272294,503128004,148176864416
2013-07-01,124,145470354637,4848225334,554047588,2788908395,406632907,148259263032
2013-07-02,123,145793434860,6140202318,604798583,2994913148,363271927,148788348008
2013-07-03,122,146331396911,6458798024,666149816,3122156208,392375429,149453553119
2013-07-04,121,146431475969,6940758376,705957074,3222892968,363351094,149654368937
2013-07-05,120,146113979021,6311258009,746417774,3346427225,295951637,149460406246
2013-07-08,119,145461882454,5161294561,765919918,3349007814,290271717,148810890268
2013-07-09,118,145223927180,4060138518,776212943,3406756562,280443999,148630683742
2013-07-10,117,145468426190,6516616406,788853066,3459103698,321720518,148927529888
2013-07-11,116,144993447524,11836354163,724533627,3534498235,405142193,148527945759
2013-07-12,115,145732591370,10184240097,543415311,3012711389,313147034,148745302759
2013-07-15,114,146480487307,8714916690,545894285,3162192097,393604878,149642679404
2013-07-16,113,147690127651,7899410046,603789521,3279213977,404277328,150969341628
2013-07-17,112,147809024524,7738122870,554605991,3120392198,362363182,150929416722
2013-07-18,111,148720424372,6705464503,502715126,2904179326,329896451,151624603698
2013-07-19,110,147876128209,7248688103,502247173,2796392120,446867647,150672520329
2013-07-22,109,148324934682,5694020549,516275709,2872246439,407632288,151197181121
2013-07-23,108,148858609892,8486417073,528495519,3001644404,465502092,151860254296
2013-07-24,107,149279195818,8617463762,554078145,2930065483,443661952,152209261301
2013-07-25,106,149232789418,7665729318,579938408,3040026973,365801524,152272816391
2013-07-26,105,148875607683,5432377690,584027672,3020509405,272334242,151896117088
2013-07-29,104,149188477758,6003177022,660636545,3146310551,364563120,152334788309
2013-07-30,103,149207743996,6003056011,668748160,3192347775,354839138,152400091771
2013-07-31,102,149420127021,5473314564,688141829,3310731997,317514868,152730859018
2013-08-01,101,149555722683,7121569170,669954254,3337528664,354785014,152893251347
2013-08-02,100,148969271079,7328513424,571196826,3167904972,244524797,152137176051
2013-08-05,99,149397053080,7193323164,562127595,3258698825,267773693,152655751905
2013-08-06,98,149657184867,8542220553,560754251,3207775784,341131891,152864960651
2013-08-07,97,150260238669,8933967401,562354436,3248447266,353901159,153508685935
2013-08-08,96,151421916796,7147549342,551215343,3184371304,302562314,154606288100
2013-08-09,95,151564666504,7775889605,532873753,3131592635,322595309,154696259139
2013-08-12,94,151556419573,10517806898,534690876,3289803971,422254784,154846223544
2013-08-13,93,152674633346,9467806071,516575565,3213818900,312581246,155888452246
2013-08-14,92,152811481913,9089551977,511343014,3191811966,354927551,156003293879
2013-08-15,91,153382068990,7899681215,483929193,3054873234,296980699,156436942224
2013-08-16,90,154515208872,13006565961,468380174,2839761298,591046376,157354970170
2013-08-19,89,154828299983,7878352329,458511012,2907723962,427495712,157736023945
2013-08-20,88,155661493166,8705919775,473710694,2935192988,432898632,158596686154
2013-08-21,87,156834706420,6940768662,456856009,2866554016,306865258,159701260436
2013-08-22,86,157187498032,7154595112,451704878,2864261101,296577412,160051759133
2013-08-23,85,157206691091,9468849165,434019283,2737223795,373467241,159943914886
2013-08-26,84,158142844823,10303492304,461360635,2962018629,449671375,161104863452
2013-08-27,83,159897225927,10505399464,455087313,2907627936,382970001,162804853863
2013-08-28,82,162036114549,12670096372,459271193,2867436147,410235222,164903550696
2013-08-29,81,163646162418,10194973629,449724419,2783127447,318545128,166429289865
2013-08-30,80,162731361276,12066151492,441431963,2786331383,398632179,165517692659
2013-09-02,79,164203170766,10893889831,441640321,2793804345,352991068,166996975111
2013-09-03,78,163836243571,9264282240,455211449,2799921927,309326278,166636165498
2013-09-04,77,164744972424,10667189067,461955387,2814405924,326141151,167559378348
2013-09-05,76,165979329356,9804211049,452218205,2760954500,279374936,168740283856
2013-09-06,75,166841574757,11281155028,458059741,2758154510,387077105,169599729267
2013-09-09,74,170263953063,19419627776,572841053,3326596369,643061268,173590549432
2013-09-10,73,173742910141,20039717034,569671648,3327962635,534984688,177070872776
2013-09-11,72,175218296628,19066763751,578514557,3342404054,434966296,178560700682
2013-09-12,71,178704168813,18661489213,597504616,3574484088,535453455,182278652901
2013-09-13,70,180047463400,14794724049,540120825,3247774810,360354435,183295238210
2013-09-16,69,182712428747,15316387321,522282478,3159050563,379393184,185871479310
2013-09-17,68,184432606809,15108935690,448774820,2863619152,315685231,187296225961
2013-09-18,67,183564952864,10866924948,411050650,2705430781,353696624,186270383645
2013-09-23,66,186139026272,13746039404,444150091,2853246774,369637645,188992273046
2013-09-24,65,187832693086,15891243985,417705709,2728328302,386715705,190561021388
2013-09-25,64,188780192009,14754504704,409763163,2709037025,368654953,191489229034
2013-09-26,63,189696837512,13657728519,358659121,2451235734,355831218,192148073246
2013-09-27,62,189444140376,10876838276,331914844,2338569970,317802283,191782710346
2013-09-30,61,187007772810,9374945480,316975815,2277092903,246562420,189284865713
2013-10-08,60,190620546052,15019950957,366879711,2507698233,384258607,193128244285
2013-10-09,59,193433461807,13769689813,357359138,2456450737,375571559,195889912544
2013-10-10,58,195962993170,15182552559,339648905,2354044553,340165921,198317037723
2013-10-11,57,197583295389,15382323544,359200108,2467334758,441604632,200050630147
2013-10-14,56,200189301778,16401031686,367437599,2495987584,393230731,202685289362
2013-10-15,55,202446094767,14754585887,366045786,2497712626,344150755,204943807393
2013-10-16,54,202459072287,14308912267,333200336,2307926333,352876240,204766998620
2013-10-17,53,203294640806,11697484959,346092176,2324039569,314307037,205618680375
2013-10-18,52,202632187972,9052738286,363569973,2392196627,340294381,205024384599
2013-10-21,51,204341953702,13903779523,371051278,2472862227,464469181,206814815929
2013-10-22,50,205600238723,14930082234,368793983,2448248584,407944680,208048487307
2013-10-23,49,205582514365,12942644847,366302833,2381959619,473153968,207964473984
2013-10-24,48,206258104969,9279885380,365061476,2350893103,366287337,208608998072
2013-10-25,47,206294779848,10652188072,340504377,2233689869,338160431,208528469717
2013-10-28,46,207060004715,8194772139,344384698,2273933933,325363016,209333938648
2013-10-29,45,205671288019,12384293585,351767184,2334651767,518587949,208005939786
2013-10-30,44,205960182509,10483842273,391498211,2493786032,477256380,208453968541
2013-10-31,43,205743564821,9119163699,384826016,2410668233,363523110,208154233054
2013-11-01,42,204392050866,7333884215,387365408,2426487149,336480756,206818538015
2013-11-04,41,205076226328,7331468487,396486629,2477597195,299001952,207553823523
2013-11-05,40,205472045476,8215742533,399299586,2496007077,368508807,207968052553
2013-11-06,39,205683423245,9209313933,386999073,2429767206,375285339,208113190451
2013-11-07,38,205764221280,7550981079,389870040,2345686986,323705640,208109908266
2013-11-08,37,205288449011,7553280095,344690470,2135590463,333473813,207424039474
2013-11-11,36,205042273510,6425591468,373798185,2177365481,307234108,207219638991
2013-11-12,35,204586680613,7050099028,413180144,2366914676,334986582,206953595289
2013-11-13,34,203714786414,7971881104,389609409,2291868589,298198432,206006655003
2013-11-14,33,204094642394,8086155715,413585407,2432882670,391075257,206527525064
2013-11-15,32,204613488552,12875770762,416139904,2471550714,475180877,207085039266
2013-11-18,31,206617132564,17385149820,534028529,3031303176,590106038,209648435740
2013-11-19,30,208019451901,14291513606,494243074,2945513244,358409734,210964965145
2013-11-20,29,209551620382,11941657028,476549154,2899116267,301975097,212450736649
2013-11-21,28,210072572200,14047646788,456017443,2836659491,446905061,212909231691
2013-11-22,27,209874858137,12613775426,439028276,2790740399,361300354,212665598536
2013-11-25,26,210513952379,11502984333,437176325,2766978465,386004112,213280930844
2013-11-26,25,211631484011,10115487484,420454976,2740380984,352605025,214371864995
2013-11-27,24,212898156243,13499390746,418182873,2796133632,512622586,215694289875
2013-11-28,23,213683293087,15322298770,406972873,2760348375,501833255,216443641462
2013-11-29,22,214338911415,12276834363,350778504,2658498226,303102807,216997409641
2013-12-02,21,214501095497,18825414865,409942747,2871419826,583814195,217372515323
2013-12-03,20,215434592177,11588419026,412217007,2875096546,397853341,218309688723
2013-12-04,19,217474470295,16912819278,412208484,2920550103,634296804,220395020398
2013-12-05,18,218992823965,13270367701,387724054,2908320533,484020701,221901144498
2013-12-06,17,219018926924,11386150208,345786178,2687886724,425520920,221706813648
2013-12-09,16,219870191278,10295777349,359392520,2691086939,444643920,222561278217
2013-12-10,15,220430882924,10904198792,362807454,2719960237,413847769,223150843161
2013-12-11,14,221251487178,11396977221,299368754,2439830624,319960864,223691317802
2013-12-12,13,221822316366,9104756903,310135655,2475665080,344642278,224297981446
2013-12-13,12,222160998519,8306245916,301534200,2400704905,301663085,224561703424
2013-12-16,11,222639526363,10065271956,293988236,2295022879,380482967,224934549242
2013-12-17,10,223119201208,7944323087,295652201,2289216797,441217017,225408418005
2013-12-18,9,223477645995,6566113157,300506152,2331707768,413646467,225809353763
2013-12-19,8,223938461000,7640597803,283875618,2222825167,409196018,226161286167
2013-12-20,7,224521974124,8431881585,237090064,1991697488,359249900,226513671612
2013-12-23,6,224630867846,6322420368,253981537,2056358199,371608489,226687226045
2013-12-24,5,224885880852,7147729797,235599691,1623243047,364602298,226509123899
2013-12-25,4,225648698731,7189385295,222519884,1601746673,384986688,227250445404
2013-12-26,3,226080169376,7599426050,219639719,1555870062,368615931,227636039438
2013-12-27,2,226225117946,7154176521,235543329,1633137598,338202390,227858255544
2013-12-30,1,227841453605,7661097572,223145036,1576943369,352047019,229418396974
2013-12-31,0,227978800560,8322266045,281121010,1941704951,395736654,229920505511
2014-01-02,244,228710320652,7318939312,224484301,1557077302,266695937,230267397954
2014-01-03,243,228595221625,8292729532,214560754,1513927862,305042145,230109149487
2014-01-06,242,228761343756,8036279087,215850289,1523790712,329112079,230285134468
2014-01-07,241,228638358705,5910246628,235286454,1583705720,368645925,230222064425
2014-01-08,240,229156113820,7463940724,242021069,1636238245,389624522,230792352065
2014-01-09,239,230020088540,8847269593,238660143,1593767536,413420487,231613856076
2014-01-10,238,229737294553,7004169454,231295830,1537336124,319225435,231274630677
2014-01-13,237,229499201270,6346364908,229413614,1568228234,462661185,231067429504
2014-01-14,236,229311743389,6685515130,241626323,1608590091,362113144,230920333480
2014-01-15,235,229811843792,7343289231,234939151,1597822610,332330199,231409666402
2014-01-16,234,230060965821,7656168912,239050510,1627160554,329057994,231688126375
2014-01-17,233,230412377549,6844410935,216779452,1526453295,281672856,231938830844
2014-01-20,232,230791913661,5607296766,212692229,1499170924,239283326,232291084585
2014-01-21,231,230777571850,6968031351,217439214,1502450099,308110357,232280021949
2014-01-22,230,231326049737,10873150808,264444360,1619788087,392040765,232945837824
2014-01-23,229,231945821615,10130547148,220619872,1495065117,280726467,233440886732
2014-01-24,228,231774564282,10368793788,190789333,1391626771,362572139,233166191053
2014-01-27,227,232466131188,10823464032,183628045,1323031454,288632280,233789162642
2014-01-28,226,231923649468,7893789417,187152618,1349330588,255296701,233272980056
2014-01-29,225,230617999048,8042093293,185304033,1337871390,208615454,231955870438
2014-01-30,224,227890201770,7046396520,152716226,1158623034,207762324,229048824804
2014-02-07,223,230299148177,10055176584,172647885,1303402675,303879043,231602550852
2014-02-10,222,233894222460,15675885762,225887393,1481220821,427008003,235375443281
2014-02-11,221,237113578259,17047728070,252608067,1588789186,529137869,238702367445
2014-02-12,220,239798698269,14427258810,238999956,1556251316,444801939,241354949585
2014-02-13,219,242214544627,16575349032,254394920,1598740564,484546617,243813285191
2014-02-14,218,242428321403,11422214895,228509451,1540651251,288082468,243968972654
2014-02-17,217,244480638839,16297930378,234841562,1609881723,351927197,246090520562
2014-02-18,216,246823602738,16987912093,215374452,1524191379,521044568,248347794117
2014-02-19,215,248756501420,16467807361,263589732,1710771073,544344331,250467272493
2014-02-20,214,249861080842,16705939916,270187624,1702618265,485700886,251563699107
2014-02-21,213,249701725590,12045784878,237719811,1549862047,303760600,251251587637
2014-02-24,212,250050968636,13189674622,216281062,1480014536,420273062,251530983172
2014-02-25,211,249672061830,15187411554,215305068,1436846056,409132399,251108907886
2014-02-26,210,250664112715,11539038673,221440769,1410092409,413732928,252074205124
2014-02-27,209,250675886815,13592753313,269433840,1624211532,576954165,252300098347
2014-02-28,208,250685575955,11898490852,249070155,1590875805,453430707,252276451760
2014-03-03,207,251983073596,12657075837,279935937,1677166495,414288005,253660240091
2014-03-04,206,252351780621,12125200646,291377717,1699560915,419070658,254051341536
2014-03-05,205,253240132979,11196972813,299624044,1750662801,364577596,254990795780
2014-03-06,204,253730966768,11798471888,276332011,1704549281,447122447,255435516049
2014-03-07,203,253050872759,11198350419,304513619,1793411804,350246872,254844284563
2014-03-10,202,252414971026,11738421987,362900252,1830208829,449345548,254245179855
2014-03-11,201,252038649300,9244370725,388371182,1917867637,518475094,253956516937
2014-03-12,200,251945854288,10131458341,422673168,1997247313,519314091,253943101601
2014-03-13,199,252761075051,10331280705,483937455,2192453531,516236308,254953528582
2014-03-14,198,252331071010,8951176202,488064245,2151721772,289536899,254482792782
2014-03-17,197,253043587759,9484884772,492981307,2184786624,346139134,255228374383
2014-03-18,196,254150400180,11016382497,488658181,2153234090,307781284,256303634270
2014-03-19,195,255575562621,10216100311,449441334,2053149380,329802162,257628712001
2014-03-20,194,255559503792,10997485798,390205441,1946992062,408416362,257506495854
2014-03-21,193,255770666920,14222628366,306673488,1740051312,694067021,257510718232
2014-03-24,192,257147141519,14887597993,358982196,1905006670,534188976,259052148189
2014-03-25,191,258315904924,12745301869,359963463,1903062121,419892694,260218967045
2014-03-26,190,259400663608,10473570962,365487641,1927608947,375383768,261328272555
2014-03-27,189,260095867854,12509484624,341174945,1858453331,527446678,261954321185
2014-03-28,188,259105897661,10963018786,322624543,1781791692,351554903,260887689353
2014-03-31,187,258890954278,8313336207,315372340,1788598988,320555736,260679553266
2014-04-01,186,258455252144,7454147839,329582717,1882870067,299476363,260338122211
2014-04-02,185,258348609225,9776632960,357172759,2028112154,509755055,260376721379
2014-04-03,184,259439552720,10708696243,338802278,1951085811,515881175,261390638531
2014-04-04,183,258587521605,8204649460,323644312,1915929285,386841831,260503450890
2014-04-08,182,259332941260,15064019071,379430465,2142303390,677734271,261475244650
2014-04-09,181,260538989557,12507535371,340435478,2046832746,378482964,262585822303
2014-04-10,180,262944130727,19699552948,395589445,2251706479,579654220,265195837206
2014-04-11,179,262883689026,14611841647,384965781,2175945347,436033396,265059634373
2014-04-14,178,264564175463,12074556314,367306449,2121974869,367334437,266686150332
2014-04-15,177,266244836275,13534438812,314794767,1903452565,294872317,268148288840
2014-04-16,176,266555259816,10267873861,330635368,1975243309,362009563,268530503125
2014-04-17,175,266776778235,10134509283,330355879,1934603170,324658411,268711381405
2014-04-18,174,266499969446,9577431792,287242016,1794892129,374983845,268294861575
2014-04-21,173,266692676276,11210339116,301789768,1769176200,477960722,268461852476
2014-04-22,172,266870388802,11267977775,305325870,1799916359,498582898,268670305161
2014-04-23,171,267460402473,8985208087,325476173,1860871023,431177873,269321273496
2014-04-24,170,266725968953,8580516470,348963789,1905803549,422788291,268631772502
2014-04-25,169,265576759765,9783865720,290233116,1721207938,398306780,267297967703
2014-04-28,168,264627794987,8967146941,257761033,1613005629,428957376,266240800616
2014-04-29,167,263634326264,7772909913,264533302,1691287829,463996527,265325614093
2014-04-30,166,262009980050,7247352226,248958249,1635791841,321016213,263645771891
2014-05-05,165,263125449389,8516572164,279157134,1728998220,437716918,264854447609
2014-05-06,164,263870108487,8424672721,291324162,1790872794,485860492,265660981281
2014-05-07,163,263849484060,7547560079,291050868,1783931061,433098190,265633415121
2014-05-08,162,263640476055,7985052061,294182863,1789704684,378944870,265430180739
2014-05-09,161,262894808767,7334172832,263259050,1705756394,409249410,264600565161
2014-05-12,160,263336148453,12716672910,316539590,1887908530,517233276,265224056983
2014-05-13,159,263875665230,10210290975,300233901,1857824098,341660691,265733489328
2014-05-14,158,263785295626,7703544903,302805472,1827570230,376333959,265612865856
2014-05-15,157,263365496848,8055799282,261473338,1714345106,436143161,265079841954
2014-05-16,156,262504748253,6777228354,254283436,1674467649,358331263,264179215902
2014-05-19,155,262978461564,8257521627,256420841,1636149807,411757235,264614611371
2014-05-20,154,263329869576,7378819909,264519437,1660684994,407006502,264990554570
2014-05-21,153,263711250561,7437968535,290253832,1769018748,554334184,265480269309
2014-05-22,152,263285667241,8451473422,293952400,1758195332,411065463,265043862573
2014-05-23,151,262179721956,7232471152,289470665,1742951754,421775919,263922673710
2014-05-26,150,261798286090,8649747489,289836117,1769480155,435522588,263567766245
2014-05-27,149,262184505749,8449243396,294368537,1786177552,464635704,263970683301
2014-05-28,148,262495558871,10723796154,312371350,1849684934,478352223,264345243805
2014-05-29,147,261867723917,9774455584,288072807,1773432798,402510032,263641156715
2014-05-30,146,260267422226,8167969061,270315721,1702233281,393229868,261969655507
2014-06-03,145,259934197396,8771506084,291677668,1785620918,481673233,261719818314
2014-06-04,144,259577930516,8028118877,271997131,1702384698,395633241,261280315214
2014-06-05,143,258996504218,7718020196,294637183,1793129953,383802206,260789634171
2014-06-06,142,258783819562,7841012896,262974892,1676569971,346320349,260460389533
2014-06-09,141,258813086318,7991678955,295477968,1790513118,468188414,260603599436
2014-06-10,140,258915454209,9738387204,330908321,1925383864,495122774,260840838073
2014-06-11,139,259331157651,9242894688,313315711,1902826720,418877395,261233984371
2014-06-12,138,260095159980,9619440443,313294537,1880328796,389478460,261975488776
2014-06-13,137,259234464249,11035429772,330619081,1932557952,526948093,261167022201
2014-06-16,136,259830180798,10960047052,383097959,2128107268,554372917,261958288066
2014-06-17,135,261262566962,10678375115,347794481,1986059991,445866109,263248626953
2014-06-18,134,263464984389,10981607193,327078543,1905445146,596836596,265370429535
2014-06-19,133,264416711355,11575621771,272158884,1692954281,471621209,266109665636
2014-06-20,132,264462000733,7311573935,256773555,1659092486,455954978,266121093219
2014-06-23,131,264423995477,7984521565,268562075,1711404991,509041591,266135400468
2014-06-24,130,264557736440,8678669140,298013493,1783361767,444842281,266341098207
2014-06-25,129,264826122031,7798911904,284059871,1729313567,386524893,266555435598
2014-06-26,128,263901777459,8934494319,291804496,1705964326,427774674,265607741785
2014-06-27,127,262843748934,10674745540,301262117,1670352288,567235752,264514101222
2014-06-30,126,263735543924,11863350290,366129787,1864005213,571830221,265599549137
2014-07-01,125,264607937184,11619124167,299236702,1728225591,328687972,266336162775
2014-07-02,124,265240147977,12502321252,321647158,1804553417,511541725,267044701394
2014-07-03,123,265974898727,13478521704,354317677,1920076729,596042331,267894975456
2014-07-04,122,265436852269,11209332181,351429329,1909107890,457240169,267345960159
2014-07-07,121,266651924011,11498589639,360983132,1964318103,459386341,268616242114
2014-07-08,120,267771059963,11443120248,356328337,1941623111,431865953,269712683074
2014-07-09,119,268976908835,13708146360,321895785,1837924169,442627206,270814833004
2014-07-10,118,270150328048,11445433593,312335779,1789239958,438918350,271939568006
2014-07-11,117,270336177205,11432852766,304315056,1743881323,387263768,272080058528
2014-07-14,116,271692944012,14022448475,320726698,1819218966,491241717,273512162978
2014-07-15,115,272382809571,13649257521,335855032,1887331655,449671396,274270141226
2014-07-16,114,273677477762,13832170116,368431573,2024579463,550544268,275702057225
2014-07-17,113,274021765613,10449050940,348209476,2020042857,364431807,276041808470
2014-07-18,112,273067071370,10487979224,363760230,2050709730,449770806,275117781100
2014-07-21,111,272800679038,10107133251,395796666,2153674887,414377242,274954353925
2014-07-22,110,273882387833,14498460951,420753681,2198534959,673156369,276080922792
2014-07-23,109,275745037661,15381414613,408977710,2215194858,608947146,277960232519
2014-07-24,108,277337816759,19341209261,480781456,2523214638,781324478,279861031397
2014-07-25,107,276338715895,16146244265,485628190,2609137766,653919936,278947853661
2014-07-28,106,275792314276,25330816505,602367464,3096334488,837980913,278888648764
2014-07-29,105,277436563438,22313772448,643909616,3273443034,570960875,280710006472
2014-07-30,104,281191829508,21820828528,621204665,3224125568,526037245,284415955076
2014-07-31,103,283472878022,19428333365,637597008,3299144167,562002156,286772022189
2014-08-01,102,282807951055,20877644942,604541045,3183147027,499792345,285991098082
2014-08-04,101,285698012007,21361247609,669994503,3494808384,622623693,289192820391
2014-08-05,100,288090413294,21974257920,646019448,3367752810,535884671,291458166104
2014-08-06,99,291615855527,22133809226,718356226,3394814354,600292309,295010669881
2014-08-07,98,294718230086,21831148630,553475703,2880806829,503910514,297599036915
2014-08-08,97,295837518089,16839331892,511141987,2739068954,457482616,298576587043
2014-08-11,96,297415010530,19756935325,595874736,3098591058,628749710,300513601588
2014-08-12,95,300455598098,20662634626,566152801,2993821657,519066175,303449419755
2014-08-13,94,304160550816,22784891797,549787632,2941328293,552469178,307101879109
2014-08-14,93,307293179271,21440618954,537777146,2848463783,524203849,310141643054
2014-08-15,92,308505667412,19882847811,549070930,2926728670,648326303,311432396082
2014-08-18,91,311144915581,22116914462,545878941,2928628202,523299838,314073543783
2014-08-19,90,314000082686,24478938058,558964767,2971229057,651976796,316971311743
2014-08-20,89,316919893355,21102254552,559844185,2952936920,585841603,319872830275
2014-08-21,88,319781417111,20937372387,522418447,2783449809,520977083,322564866920
2014-08-22,87,320712615102,20931605475,539562024,2777758609,558178032,323490373711
2014-08-25,86,322692875254,20660713907,525815421,2712634191,621002441,325405509445
2014-08-26,85,324639044384,19645912134,477910818,2545234947,514061085,327184279331
2014-08-27,84,327033468171,15775159716,466948496,2506072682,621260285,329539540853
2014-08-28,83,331974283614,18075448159,416710514,2306178645,647097944,334280462259
2014-08-29,82,333028014188,14869789058,427854960,2336768882,584884633,335364783070
2014-09-01,81,334993392377,19375199451,420833944,2353464222,526996495,337346856599
2014-09-02,80,334304257645,25074482942,459853238,2575067297,748140249,336879324942
2014-09-03,79,334451881572,28142266923,510673136,2802271135,754505396,337254152707
2014-09-04,78,337616642418,27868392314,557972740,2987580074,631924778,340604222492
2014-09-05,77,337114774267,27435309267,607844092,3167707067,718005670,340282481334
2014-09-09,76,342444319645,29429506399,604878031,3157574813,674256665,345601894458
2014-09-10,75,347084945437,26516564784,524305237,2844850067,689374080,349929795504
2014-09-11,74,351356901278,31551508007,508336149,2809839184,813463327,354166740462
2014-09-12,73,354592937514,25877300283,524061365,2854744948,677360994,357447682462
2014-09-15,72,360155185805,30277233230,493654518,2786068344,741223637,362941254149
2014-09-16,71,364561939383,38576347008,494045733,2675808937,882829505,367237748320
2014-09-17,70,368035491871,24747959534,481116386,2633272090,759755012,370668763961
2014-09-18,69,371022528916,23454655704,515412100,2754050358,910651338,373776579274
2014-09-19,68,371414736256,23437077528,505039270,2743342013,779322832,374158078269
2014-09-22,67,377641662610,26802465503,444658130,2472695378,611299373,380114357988
2014-09-23,66,380499940014,22613124910,476327632,2580377167,851878416,383080317181
2014-09-24,65,388077718595,35224990253,516421911,2717092663,1100530763,390794811258
2014-09-25,64,393151191091,35791324236,488477394,2618340050,904722652,395769531141
2014-09-26,63,395131055448,27354261183,519168328,2654825242,850494322,397785880690
2014-09-29,62,393042488212,28613142315,507492826,2644410326,757653472,395686898538
2014-09-30,61,386227534354,27147344071,447007098,2402153637,672778691,388629687991
2014-10-08,60,397396842118,37442090357,559818258,2836409256,923699622,400233251374
2014-10-09,59,403598187437,36582698297,547404751,2858754154,811258045,406456941591
2014-10-10,58,407459730065,34135897574,536135153,2772753535,768465628,410232483600
2014-10-13,57,413817989559,31602674452,519860635,2684864566,749586286,416502854125
2014-10-14,56,417913475124,30016767013,534018157,2752285172,783993509,420665760296
2014-10-15,55,422266917101,31845671858,552337971,2885487467,774764311,425152404568
2014-10-16,54,424530873677,35283134771,585040803,3010510230,931306322,427541383907
2014-10-17,53,425311288395,29063327336,487718729,2654957393,743205694,427966245788
2014-10-20,52,427824766563,23487001573,537157389,2824265997,748585888,430649032560
2014-10-21,51,430306864259,24884170638,536925943,2802116786,713476074,433108981045
2014-10-22,50,432871031115,24355603992,494400773,2693781267,822328450,435564812382
2014-10-23,49,436985726360,25192335627,408886028,2340514878,817182870,439326241238
2014-10-24,48,439035804092,20161466320,372718592,2199412318,720012033,441235216410
2014-10-27,47,441744151692,20724534608,332511522,1996485943,799180180,443740637635
2014-10-28,46,440302363994,27452149524,404811012,2314768155,893030334,442617132149
2014-10-29,45,439652493432,37671197598,479029360,2611824795,943217116,442264318227
2014-10-30,44,443442891214,39726432779,571062165,2863055358,1049889692,446305946572
2014-10-31,43,444331032561,42922083624,644906244,3139694050,1093918443,447470726611
2014-11-03,42,449802419175,41008787115,648973897,3221660705,992203255,453024079880
2014-11-04,41,453445058673,39878215488,647859142,3196509968,955937193,456641568641
2014-11-05,40,456679655698,35525776693,650164593,3175028313,935088084,459854684011
2014-11-06,39,460287164514,31786397981,622440545,3071093972,883170931,463358258486
2014-11-07,38,460794750926,43096954614,653784032,3151991170,1139240456,463946742096
2014-11-10,37,464090522420,43074937834,827763105,3775253288,1208677572,467865775708
2014-11-11,36,468511764722,59512181726,800379944,3677941190,1203971043,472189705912
2014-11-12,35,471792706194,38069159328,832982089,3882134761,1093428955,475674840955
2014-11-13,34,474102238964,47038257972,845053146,3918633272,1089309031,478020872236
2014-11-14,33,474451979124,33685785420,809489891,3805366969,859203537,478257346093
2014-11-17,32,476797912474,33657280576,758355649,3685735609,796147149,480483648083
2014-11-18,31,479387054532,30864025290,671129141,3318621527,841441801,482705676059
2014-11-19,30,481691069603,29457074491,665399210,3264178092,892735104,484955247695
2014-11-20,29,483384872787,26772643084,695967139,3367936291,868061627,486752809078
2014-11-21,28,485787498700,37965320439,669336273,3334098780,1042151760,489121597480
2014-11-24,27,499260287798,69936096428,662448084,3450542062,1453456183,502710829860
2014-11-25,26,509781678532,59098287139,700758902,3601461778,1196315299,513383140310
2014-11-26,25,518602496677,67013032917,755040399,3830675045,1220782039,522433171722
2014-11-27,24,522913808670,67309594520,805062141,4099983450,1303976656,527013792120
2014-11-28,23,528992449890,77397865373,889100209,4426133104,1491509405,533418582994
2014-12-01,22,538392930415,77440824794,921040710,4568075249,1378086937,542961005664
2014-12-02,21,545712569004,76886420448,923073399,4828937503,1541232526,550541506507
2014-12-03,20,552052549201,99700572568,903194391,4791756429,1448412944,556844305630
2014-12-04,19,569429142951,105227574155,941956620,5252685856,1573490018,574681828807
2014-12-05,18,575483801438,113474295457,892615083,5035049577,1540867053,580518851015
2014-12-08,17,595995563719,114513688894,995831230,5686867709,1709393286,601682431428
2014-12-09,16,605492638583,121843297582,914927637,5039482033,1591762695,610532120616
2014-12-10,15,614042935191,92619534535,841858350,4845585561,1616220166,618888520752
2014-12-11,14,617381768756,81319089922,854689464,4817034195,1443866814,622198802951
2014-12-12,13,619376064853,73760055817,815521523,4628969709,1325624254,624005034562
2014-12-15,12,628731166297,76617552763,814475178,4669814929,1349573360,633400981226
2014-12-16,11,637958256722,92376303515,853613379,4957962271,1765606520,642916218993
2014-12-17,10,648449628389,105662386619,865219858,5036994474,1821400330,653486622863
2014-12-18,9,657356997782,86108084304,872698179,5116335254,1566415717,662473333036
2014-12-19,8,667260348402,87986460410,859906608,4990159015,1622112746,672250507417
2014-12-22,7,670595742509,96086844112,890122025,5146324106,1413056150,675742066615
2014-12-23,6,669005263570,68088717135,847853767,4905506876,1286459935,673910770446
2014-12-24,5,667220851499,60785434137,783877016,4423264212,1386061393,671644115711
2014-12-25,4,672974233665,66548637889,884652636,5075978446,1692348394,678050212111
2014-12-26,3,678646298701,87566428865,908219276,5392786771,1569099080,684039085472
2014-12-29,2,687678463441,102445925919,921606454,5485660125,1498505294,693164123566
2014-12-30,1,691781993774,76341827158,956068448,5620343498,1410191883,697402337272
2014-12-31,0,690304859709,80629221496,1033591309,6213794573,1501441714,696518654282
2015-01-05,243,700007355731,102462217665,998243783,6127222126,1448182019,706134577857
2015-01-06,242,707391292198,98370829909,972732503,5990342373,1251407226,713381634571
2015-01-07,241,715729306750,81243060299,999317750,6161617855,1159975687,721890924605
2015-01-08,240,718485280095,72365046460,943391394,5627589892,982279484,724112869987
2015-01-09,239,726400724109,87327038290,918874498,5383417787,1538413338,731784141896
2015-01-12,238,735878164519,68855556662,871073168,5080926118,1075613449,740959090637
2015-01-13,237,740893116001,52882711315,853669905,4970840174,1100244336,745863956175
2015-01-14,236,749750725573,55908600370,819901731,4832460055,1031836955,754583185628
2015-01-15,235,762382827637,71147906275,837376405,5061962503,1305319686,767444790140
2015-01-16,234,766660200847,83138464387,836900593,5019945559,1212010371,771680146406
2015-01-19,233,752047988453,72756876383,695039440,4006316935,1100466344,756054305388
2015-01-20,232,750762421151,76513181618,719397938,4089037320,1507143437,754851458471
2015-01-21,231,754595954233,91163378655,817893900,4822496958,1722377359,759418451191
2015-01-22,230,761668956446,75064691111,816099513,4785141949,973298500,766454098395
2015-01-23,229,766038511313,82258662501,794384758,4700104444,1307260513,770738615757
2015-01-26,228,771373532853,67111894515,823866912,4885928763,1159453953,776259461616
2015-01-27,227,773837742011,75031235777,798720421,4699665607,1220933535,778537407618
2015-01-28,226,775933490835,63920072891,773840993,4542722686,1190286348,780476213521
2015-01-29,225,777561647997,55046202356,736792799,4327857932,998013384,781889505929
2015-01-30,224,773977698926,50312558223,690478134,4040912993,914321293,778018611919
2015-02-02,223,774866786825,47632245458,638069320,3768751438,998229174,778635538263
2015-02-03,222,773741930732,52159764433,687277595,4125153312,1068524030,777867084044
2015-02-04,221,774770652233,55998184225,694053449,4075255266,1199049654,778845907499
2015-02-05,220,777970437249,70696075163,675814531,3951049404,1324122648,781921486653
2015-02-06,219,779641865766,51350016719,564209002,3355007223,1289932980,782996872989
2015-02-09,218,786747284226,51281340753,552250455,3292347071,1497271319,790039631297
2015-02-10,217,797891845821,49940656430,547550167,3321741382,1402007917,801213587203
2015-02-11,216,805111175134,49814292794,552555015,3376239249,1102904755,808487414383
2015-02-12,215,804093283315,49061175820,533390006,3307983650,982933954,807401266965
2015-02-13,214,779162373527,52535663244,529972301,3311066082,962369402,782473439609
2015-02-16,213,772980408663,53928574063,506514032,3238037227,860489122,776218445890
2015-02-17,212,753461212526,49701309648,468094316,3034256889,674412666,756495469415
2015-02-25,211,770968145360,60092819984,522163877,3277751249,819377339,774245896609
2015-02-26,210,778901920692,70218750802,600194304,3727497308,1245468190,782629418000
2015-02-27,209,780843947820,67295472698,578066058,3643957926,906278384,784487905746
2015-03-02,208,792791389697,79111411070,600182396,3820324241,1086852330,796611713938
2015-03-03,207,804100125942,87283032063,561490657,3658347664,1188200050,807758473606
2015-03-04,206,811253368861,66225246334,590422635,3800138283,1108455680,815053507144
2015-03-05,205,819402239652,70255155893,558295958,3596427868,1277060227,822998667520
2015-03-06,204,824379989028,61530416037,529268837,3441280015,1400398864,827821269043
2015-03-09,203,834878753182,70291104924,520205890,3353984453,1878488806,838232737635
2015-03-10,202,848537789505,68915727800,505009170,3099078967,1633891332,851636868472
2015-03-11,201,864004113742,65924942057,458202242,2927592012,1480830901,866931705754
2015-03-12,200,878075844620,85412099181,495994833,3182040688,1862531473,881257885308
2015-03-13,199,880611781488,76456008406,492300090,3193989076,1428684781,883805770564
2015-03-16,198,874850559115,93488482835,529826432,3535076305,1466225810,878385635420
2015-03-17,197,881882625541,118453665965,556521021,3731158044,1950507069,885613783585
2015-03-18,196,896108504027,123253353097,627925841,4223177943,2044008241,900331681970
2015-03-19,195,911756727783,119422295098,614805850,4136003055,1602861352,915892730838
2015-03-20,194,927002173004,133491591365,657654705,4317418963,1858440114,931319591967
2015-03-23,193,935961490802,122350894415,732427324,4789023959,1690085064,940750514761
2015-03-24,192,948928112150,145585328346,689082182,4619080288,1829457216,953547192438
2015-03-25,191,960086790787,115371500560,698297120,4643215819,1524507026,964730006606
2015-03-26,190,971529344684,117308029200,717948665,4759646631,1763608907,976288991315
2015-03-27,189,974695451811,94331337806,742424285,4882309085,1661692649,979577760896
2015-03-30,188,987305162447,128248977117,840090452,5489035498,2127987302,992794197945
2015-03-31,187,992114591127,116775077460,815494453,5408130188,1326090630,997522721315
2015-04-01,186,1007500876332,112637594862,839075487,5579432794,1729479501,1013080309126
2015-04-02,185,1019832320645,122445942102,845035143,5605667753,1548304018,1025437988398
2015-04-03,184,1028339497560,121745692024,833666811,5639393066,1685019881,1033978890626
2015-04-07,183,1049019510305,135205459177,890246879,6052607373,1812376621,1055072117678
2015-04-08,182,1063907515309,146795417745,883306430,6090844298,1811107279,1069998359607
2015-04-09,181,1080032082669,151266260607,950252465,7459280657,1839296323,1087491363326
2015-04-10,180,1093646777627,120171575492,851628036,6013790547,1903813388,1099660568174
2015-04-13,179,1112644681454,125462079457,837423227,6012263982,1717712021,1118656945436
2015-04-14,178,1132444514795,135681414792,808065982,5734278801,2105259947,1138178793596
2015-04-15,177,1146127306376,127637503244,815236850,5760511452,2243634120,1151887817828
2015-04-16,176,1157182044282,112006268973,820992013,5973347250,2203963301,1163155391532
2015-04-17,175,1149157713135,129211438621,819750253,6041055352,1380227173,1155198768487
2015-04-20,174,1143069525623,165794251895,806776144,5886540287,1954779241,1148956065910
2015-04-21,173,1153574815097,143192898510,800532646,5961506282,1946106430,1159536321379
2015-04-22,172,1172665362874,165509139277,841589251,6368406198,2106225741,1179033769072
2015-04-23,171,1185643651435,171737823864,839707386,6278465187,2013411225,1191922116622
2015-04-24,170,1192302971884,153156908610,793270872,5965256427,1641802815,1198268228311
2015-04-27,169,1210543730393,162760454052,829882223,6254062725,1970873725,1216797793118
2015-04-28,168,1215607398598,148772163843,818516118,6149727519,2090163995,1221757126117
2015-04-29,167,1221406603476,126739953108,794875454,6021609553,1887770640,1227428213029
2015-04-30,166,1224334129835,135754031359,783508407,5831675719,1749354418,1230165805554
2015-05-04,165,1241303319482,116900666542,821124336,5999922775,1694089441,1247303242257
2015-05-05,164,1244231572418,128460864619,692133030,4992896354,1724892827,1249224468772
2015-05-06,163,1258820234374,122153633570,647179937,4701559723,1579163978,1263521794097
2015-05-07,162,1265872162917,94358842320,528167454,4030097633,1586470622,1269902260550
2015-05-08,161,1245786699057,87812628024,536002927,4135054341,1669321134,1249921753398
2015-05-11,160,1247505935416,119726264827,628804192,4834763087,2141547740,1252340698503
2015-05-12,159,1256607720425,136448970581,707971746,5319748801,2148465499,1261927469226
2015-05-13,158,1265406189486,132209749584,744973638,5472339769,1836400568,1270878529255
2015-05-14,157,1271467867961,105312775966,727304965,5402256675,1732086628,1276870124636
2015-05-15,156,1270378616254,103539242662,622531450,4746218114,1692384011,1275124834368
2015-05-18,155,1278951775452,95383811648,619939863,4622251110,1578107544,1283574026562
2015-05-19,154,1294245193796,113575243435,614797160,4763472053,2008707627,1299008665849
2015-05-20,153,1310006880147,117098266840,601080316,4656256937,1687963151,1314663137084
2015-05-21,152,1321176723760,108553228977,634903922,4925644941,1303497207,1326102368701
2015-05-22,151,1314567656582,142752614727,665671261,5329555085,1773361484,1319897211667
2015-05-25,150,1318998299726,164145678044,745828808,6190475546,1748595767,1325188775272
2015-05-26,149,1329561906147,159094373511,769896709,6488280901,1505908324,1336050187048
2015-05-27,148,1336990097550,126358447704,751439850,6425385136,1230064283,1343415482686
2015-05-28,147,1345459596439,161711190822,653062958,5430216405,1479510294,1350889812844
2015-05-29,146,1348287000435,109545698973,591895544,4975685928,1535238736,1353262686363
2015-06-01,145,1367127995718,117887770661,627008827,5237617260,1888828181,1372365612978
2015-06-02,144,1387882217728,133758105973,608826462,5040510626,1787608851,1392922728354
2015-06-03,143,1402927079454,119037456520,593948327,4894947220,1550105851,1407822026674
2015-06-04,142,1412300874405,140960563937,594151113,4894445720,2091611178,1417195320125
2015-06-05,141,1412610800411,162459513338,626982856,5196658863,1397258933,1417807459274
2015-06-08,140,1419155431830,175635531492,706327864,6066372273,2153296135,1425221804103
2015-06-09,139,1428637577543,147185167674,692502719,5856847970,1866304046,1434494425513
2015-06-10,138,1436953511811,132102202755,682946816,5922838027,1776050760,1442876349838
2015-06-11,137,1443868735753,132745195582,735640495,6044144042,1564930174,1449912879795
2015-06-12,136,1453579989204,140782088205,734805206,6017861873,1829689029,1459597851077
2015-06-15,135,1460771548784,139727644688,714394315,5678984181,1683932637,1466450532965
2015-06-16,134,1463951216264,110467806485,651077472,5010413917,1376855849,1468961630181
2015-06-17,133,1475103559271,108881795164,528983150,4411760221,2174586687,1479515319492
2015-06-18,132,1482910960306,102883459843,490123431,4003390202,1732961716,1486914350508
2015-06-19,131,1479299517720,93916444426,381455997,3056543634,1576419073,1482356061354
2015-06-23,130,1468845650070,71923409449,394954446,3262509775,1354114297,1472108159845
2015-06-24,129,1439971876069,99110730843,467537982,3870183220,1833444664,1443842059289
2015-06-25,128,1423248786555,112543339631,526175532,4077042981,1904698270,1427325829536
2015-06-26,127,1387049624743,97236522159,420715654,3047418280,2085715999,1390097043023
2015-06-29,126,1360422100831,111777711829,447069571,2869439317,2590020801,1363291540148
2015-06-30,125,1335503814173,111609532061,399448299,2962511878,2611587657,1338466326051
2015-07-01,124,1328818572775,102412410526,446136047,3032047503,2191541832,1331850620278
2015-07-02,123,1293827661966,88487618099,361945765,2509128299,2453422624,1296336790265
2015-07-03,122,1244976682669,75761353558,291951070,1946060586,1195700702,1246922743255
2015-07-06,121,1151409843974,86253165993,272593963,1913867669,280953116,1153323711643
2015-07-07,120,1053097367290,65565705505,272716395,1858251281,209434967,1054955618571
2015-07-08,119,940870474994,40122005740,263508669,1621043791,126455954,942491518785
2015-07-09,118,927849404820,85033177459,264901325,1692753289,129269092,929542158109
2015-07-10,117,932305971025,99007475226,253333446,1763754984,136284948,934069726009
2015-07-13,116,934271207261,108699727868,272290354,1857208347,142599558,936128415608
2015-07-14,115,936754623345,112517508100,286888194,1835725241,156604000,938590348586
2015-07-15,114,920524732197,87450742190,293027310,1834758822,307415748,922359491019
2015-07-16,113,918396130560,75364896359,288475352,1774737334,295156145,920170867894
2015-07-17,112,921338704319,88919851672,283823973,1822969650,289434379,923161673969
2015-07-20,111,921348386943,94950968728,355248393,2193555412,430413418,923541942355
2015-07-21,110,928615710814,95165466241,378307958,2335036599,431586479,930950747413
2015-07-22,109,928881478891,94378343848,385666185,2361120493,517651117,931242599384
2015-07-23,108,941369680547,109984949964,370551723,2262926970,597044652,943632607517
2015-07-24,107,940822832963,121558351199,396426559,2342381838,802224078,943165214801
2015-07-27,106,919373759165,91115117073,402985425,2140343412,805299888,921514102577
2015-07-28,105,887462793572,69518139535,372369603,2041011444,668174860,889503805016
2015-07-29,104,881733008327,71228735424,399846272,2204435202,768767663,883937443529
2015-07-30,103,881652186879,82706905549,431124222,2241704283,697464218,883893891162
2015-07-31,102,859970601967,50034690518,431901758,2232410006,490047392,862203011973
2015-08-03,101,832475432082,41851431424,481095430,2491448013,344467544,834966880095
2015-08-04,100,842108030431,60977446773,477989807,2611179954,20185344,844719210385
2015-08-05,99,842301741836,63096752525,472649945,2511051535,8743388,844812793371
2015-08-06,98,839838718760,46010651060,466095533,2453501723,9671800,842292220483
2015-08-07,97,845629259242,63254755083,396348385,2148973829,5112403,847778233071
2015-08-10,96,861223721255,98653015518,420358094,2386249912,35050560,863609971167
2015-08-11,95,870103319713,104695193380,416370751,2286113685,16105307,872389433398
2015-08-12,94,873794479627,84189224771,437869763,2402549957,33045600,876197029584
2015-08-13,93,882774372393,86857774356,430766284,2351486477,30547700,885125858870
2015-08-14,92,886085989804,94821464981,378537615,2238103960,32101979,888324093764
2015-08-17,91,894506794785,93341898906,405085221,2483435259,55929141,896990230044
2015-08-18,90,879899884284,99199001573,424822078,2533802842,66503798,882433687126
2015-08-19,89,875442817227,81247402297,405080751,2367304973,60862980,877810122200
2015-08-20,88,869228227066,67585656067,399200479,2358282923,42621897,871586509989
2015-08-21,87,848630862572,51673986450,381279185,2195223661,44073116,850826086233
2015-08-24,86,795943105071,38245805551,391807060,2004816456,60377862,797947921527
2015-08-25,85,740536035623,38055426386,397121654,1871872598,57083825,742407908221
2015-08-26,84,706522058254,49181259228,405021453,1942973253,39309111,708465031507
2015-08-27,83,685022556433,45681104014,444885202,2124421074,68989700,687146977507
2015-08-28,82,683118490904,59881095450,410690598,2206833724,27151623,685325324628
2015-08-31,81,673127713583,49354997209,438264408,2312390948,46944193,675440104531
2015-09-01,80,642834471301,37495050672,418349037,2242361038,23722684,645076832339
2015-09-02,79,606266170176,31013732169,417710441,2217686789,18465787,608483856965
2015-09-07,78,615872695111,42713833063,421182250,2180453879,18633460,618053148990
2015-09-08,77,613326503591,32848347074,424435597,2294014252,25730004,615620517843
2015-09-09,76,622302002741,56720402464,417691860,2290625741,22264550,624592628482
2015-09-10,75,619885682685,35958226095,421792143,2279414099,24070525,622165096784
2015-09-11,74,618850315756,32940214326,410790112,2152125434,13731927,621002441190
2015-09-14,73,599879253495,38443650467,420568640,2148978177,26778906,602028231672
2015-09-15,72,587114144804,26800136447,416115086,2037093535,15951066,589151238339
2015-09-16,71,588177192339,36654734196,403119490,2076672895,15983035,590253865234
2015-09-17,70,590467294488,45357176136,400378022,2013711808,15327924,592481006296
2015-09-18,69,588929671900,27492470550,397227742,2025406214,8837480,590955078114
2015-09-21,68,589611425721,32786118443,395252238,2059120123,9537520,591670545844
2015-09-22,67,590105583869,39312342594,396046839,2082180629,9943300,592187764498
2015-09-23,66,588155766896,31571539567,393064710,2021242749,8809288,590177009645
2015-09-24,65,588059276593,29077086812,396396967,2052014070,9860961,590111290663
2015-09-25,64,579163991185,28658919129,396562589,2003971580,9271541,581167962765
2015-09-28,63,578137194581,20771544015,402863318,2037096084,12470521,580174290665
2015-09-29,62,573430370272,19494241880,395762758,1945833567,12445887,575376203839
2015-09-30,61,565107689421,16667737149,383111420,1870766950,6144567,566978456371
2015-10-08,60,573423934505,38105508897,390126838,2010065774,12684959,575434000279
2015-10-09,59,573834927910,34773511196,392219396,2021609337,14676064,575856537247
2015-10-12,58,590826463139,66079680740,385880309,2062409620,16875892,592888872759
2015-10-13,57,592359492869,46417951657,384657890,2051103491,12068699,594410596360
2015-10-14,56,595465800492,47314578853,388244607,2049097950,17526826,597514898442
2015-10-15,55,600862476185,55174519045,383678231,2088067241,18192543,602950543426
2015-10-16,54,602483217134,67307333866,364342531,2040780928,14634022,604523998062
2015-10-19,53,608423367347,66704231174,371370016,2061897151,17272456,610485264498
2015-10-20,52,614565648086,57331561590,376760079,2093241125,15975774,616658889211
2015-10-21,51,609597972675,75043684698,377978484,2036721856,21703255,611634694531
2015-10-22,50,614855939334,56765942023,370468855,2034048338,14514477,616889987672
2015-10-23,49,618715633159,64264021721,367394423,2046744342,10908942,620762377501
2015-10-26,48,625445402262,71288228506,367271524,2039335651,10104146,627484737913
2015-10-27,47,628033239007,61805047765,369466382,2051580154,10231694,630084819161
2015-10-28,46,625971542441,51781988858,380712918,2068703219,19354621,628040245660
2015-10-29,45,628413061152,41575064417,368158409,2016767500,8236652,630429828652
2015-10-30,44,626861304247,46046145880,362957410,1984153934,10749359,628845458181
2015-11-02,43,624580223050,39182710955,371177740,1976302866,17635200,626556525916
2015-11-03,42,624641794601,32485266484,365526279,1955303083,13980500,626597097684
2015-11-04,41,636455607760,71377497141,363955809,2047299675,25119007,638502907435
2015-11-05,40,648756449213,116126616192,359542968,2064814208,22044639,650821263421
2015-11-06,39,657355073852,96065908261,361556937,2093561252,21716435,659448635104
2015-11-09,38,678846032704,114272067940,372673657,2153097052,29373118,680999129756
2015-11-10,37,692849446365,103276201336,371208287,2130119832,18309865,694979566197
2015-11-11,36,698588480945,81460138173,367078322,2105019973,13686632,700693500918
2015-11-12,35,704264669504,79386000166,372418079,2136717070,20899004,706401386574
2015-11-13,34,704017531196,76119157073,376682738,2161492893,28225311,706179024089
2015-11-16,33,709765973662,59783115668,377786256,2178454674,25881903,711944428336
2015-11-17,32,719146385419,90257897879,381601346,2208478503,23878676,721354863922
2015-11-18,31,718128393345,61645301015,384979790,2182866762,26764655,720311260107
2015-11-19,30,723677944809,53377151926,372174144,2155202427,14272579,725833147236
2015-11-20,29,727483864902,67868870592,377815849,2178878860,22640171,729662743762
2015-11-23,28,724944067772,56462012238,374923464,2170416716,20020203,727114484488
2015-11-24,27,724356454195,41952155661,375998490,2168170720,18347650,726524624915
2015-11-25,26,722871325612,50585918649,372479695,2175357594,20468421,725046683206
2015-11-26,25,721562735545,57063284399,372526076,2215328433,24195577,723778063978
2015-11-27,24,707571655449,56361735197,376670438,2061163221,37988666,709632818670
2015-11-30,23,705712846824,47647190662,371883683,2023533716,33414645,707736380540
2015-12-01,22,707573181220,41187948449,373033872,2077790582,30813241,709650971802
2015-12-02,21,705719889489,50746609725,378148759,2186265522,33975876,707906155011
2015-12-03,20,701215140017,45460715372,376325461,2150847061,30091638,703365987078
2015-12-04,19,689229679014,36130370822,377744415,2100381786,27582238,691330060800
2015-12-07,18,688643130171,34763101101,385234259,2149554072,25501351,690792684243
2015-12-08,17,683538869003,34153742415,393814894,2148104647,32121694,685686973650
2015-12-09,16,681876332446,31912185019,390034517,2123493880,23454107,683999826326
2015-12-10,15,680181466516,33681721847,393550719,2141678490,28977892,682323145006
2015-12-11,14,679172485848,28365988971,392705280,2101063966,39897286,681273549814
2015-12-14,13,686734828731,41328859936,370443012,2105881193,36024800,688840709924
2015-12-15,12,686903667749,37186068080,358313963,2022022178,24072759,688925689927
2015-12-16,11,687294173008,34465314026,364969521,2042483132,32766707,689336656140
2015-12-17,10,685514996801,48712938670,377411347,2197465782,46942828,687712462583
2015-12-18,9,685013347232,47396383227,370577565,2166047057,27117647,687179394289
2015-12-21,8,690204973913,57466371747,387937372,2273711965,42034047,692478685878
2015-12-22,7,694584343597,52008901722,379497194,2216629408,27847268,696800973005
2015-12-23,6,701576990450,66173764807,401880906,2305921763,51599272,703882912213
2015-12-24,5,704055938831,45768190084,379028086,2162580784,30225902,706218519615
2015-12-25,4,702906554042,36861998896,375090359,2152587073,25677739,705059141115
2015-12-28,3,690842371910,43463435651,379235236,2108756268,32431310,692951128178
2015-12-29,2,689699599137,28878201901,384517703,2141562769,32745600,691841161906
2015-12-30,1,690624418175,34774521611,387461740,2134120717,26235283,692758538892
2015-12-31,0,680522261155,26481517358,389898016,2110497327,25617261,682632758482
2016-01-04,243,674250015171,27746141351,378549763,1930428580,14767084,676180443751
2016-01-05,242,662424991011,32738126135,386320746,1965327469,31410622,664390318480
2016-01-06,241,659659894611,31039624222,397866642,2025469549,28591279,661685364160
2016-01-07,240,653619923734,8743686393,389379514,1865346141,4980100,655485269875
2016-01-08,239,640940954450,32514181166,366022477,1797468141,20464535,642738422591
2016-01-11,238,622258836431,28150988168,378464622,1722772476,30254704,623981608907
2016-01-12,237,610486743606,21769602015,361694462,1687383077,20604486,612174126683
2016-01-13,236,600445497232,19525346812,367700213,1671474368,22850084,602116971600
2016-01-14,235,594163365933,22803175759,352386407,1651483595,18888607,595814849528
2016-01-15,234,585478803003,20242663855,360131694,1613659931,28249261,587092462934
2016-01-18,233,584010365373,19081125394,368936025,1642374141,23324293,585652739514
2016-01-19,232,583401330073,25220485677,388529453,1761695979,39923341,585163026052
2016-01-20,231,581973101059,25779016479,389257526,1710066593,42551370,583683167652
2016-01-21,230,577982711229,22361174852,399730250,1757858947,38134401,579740570176
2016-01-22,229,574703509699,17864511418,377134445,1667792073,16171099,576371301772
2016-01-25,228,573053955612,16889289523,377897322,1696416297,16201169,574750371909
2016-01-26,227,558948682056,19547611732,386461946,1587722289,26214474,560536404345
2016-01-27,226,546309759767,19749649503,371387521,1610207999,21792114,547919967766
2016-01-28,225,537399576006,14896970875,370276921,1540722949,27725726,538940298955
2016-01-29,224,533033638244,18426533048,357231158,1535234350,22432638,534568872594
2016-02-01,223,528384301655,14080422778,353673284,1485180379,17458549,529869482034
2016-02-02,222,528845887864,17563888365,349593177,1511792608,17212053,530357680472
2016-02-03,221,526428042632,14409477762,344837635,1491080478,12578548,527919123110
2016-02-04,220,524337017843,18541568615,338921731,1482084171,17319810,525819102014
2016-02-05,219,514093133618,11901318369,321846648,1357030571,15155083,515450164189
2016-02-15,218,515256205943,14930797529,338742330,1420264176,33851000,516676470119
2016-02-16,217,518215198164,23605306843,353115874,1545662014,29933324,519760860178
2016-02-17,216,518778341837,24752742440,384911339,1657639909,39836772,520435981746
2016-02-18,215,519382998740,25395778727,383913855,1646122131,14700841,521029120871
2016-02-19,214,517832856204,18210153720,371916455,1595130626,10528154,519427986830
2016-02-22,213,519250340741,27522280606,386373075,1692811572,25534802,520943152313
2016-02-23,212,519105100581,23392174306,390237467,1689257065,15163588,520794357646
2016-02-24,211,520489250248,26164786546,395478038,1730924643,16853216,522220174891
2016-02-25,210,513548523851,28390233205,399914491,1632454971,27139662,515180978822
2016-02-26,209,509938422697,18373537956,399871995,1639939436,25497960,511578362133
2016-02-29,208,501041987179,16891230852,405231549,1622773378,23683654,502664760557
2016-03-01,207,499909493421,18523989704,404307775,1688144824,23312246,501597638245
2016-03-02,206,502350546037,29767561155,410569729,1779203410,37776502,504129749447
2016-03-03,205,503092878470,31372321447,418744722,1811602760,27678909,504904481230
2016-03-04,204,494927660917,27790003531,428495044,1855487471,38390367,496783148388
2016-03-07,203,497412906564,24748130963,417247123,1835425882,17338244,499248332446
2016-03-08,202,495750615429,23630997269,414150365,1834114044,19682643,497584729473
2016-03-09,201,492829696125,17033964898,430283330,1893220284,26064592,494722916409
2016-03-10,200,492042339533,14785943211,428684047,1836636431,11993988,493878975964
2016-03-11,199,489799692896,12450405720,420066293,1805079703,16191312,491604772599
2016-03-14,198,493687362449,23766199588,411291055,1810427012,19494774,495497789461
2016-03-15,197,490445133204,16199416635,426634136,1861084281,37963414,492306217485
2016-03-16,196,483482073240,14991423218,438763762,1891260265,31708062,485373333505
2016-03-17,195,488497078304,26128781409,374694739,1724225667,12120751,490221303971
2016-03-18,194,494872388714,39428741515,368296267,1711273806,30866936,496583662520
2016-03-21,193,505682813378,50440582760,344925865,1710875104,33931700,507393688482
2016-03-22,192,507364047862,37857788437,326074971,1604722826,15475715,508968770688
2016-03-23,191,509741838074,31494180992,337341767,1636604122,23831931,511378442196
2016-03-24,190,509172156706,31986208234,352121756,1645545414,31359522,510817702120
2016-03-25,189,508638683094,22318847529,353769333,1635002895,40192809,510273685989
2016-03-28,188,509242174833,27189283089,372864875,1684440686,36392082,510926615519
2016-03-29,187,508525327296,21930279771,396181058,1719011642,47876219,510244338938
2016-03-30,186,509691637569,27927803064,405685748,1774343291,35280473,511465980860
2016-03-31,185,510077307223,31153041676,413712825,1794732449,25351060,511872039672
2016-04-01,184,506119519804,24633167935,425548227,1831175662,28752399,507950695466
2016-04-05,183,512243331494,37092235507,418589155,1822755249,21010858,514066086743
2016-04-06,182,513684986113,31676123292,425300564,1833000949,18494058,515517987062
2016-04-07,181,512796499453,28556687517,430255162,1831830901,22893346,514628330354
2016-04-08,180,509745451220,22781696856,439807776,1843290164,35715099,511588741384
2016-04-11,179,512127578457,30698107375,437973551,1870649303,14677265,513998227760
2016-04-12,178,510211622132,22416237700,442288992,1879843609,20861007,512091465741
2016-04-13,177,514174217320,42312313729,427622877,1858861764,28609114,516033079084
2016-04-14,176,515461028742,28430104632,423652179,1863849047,21268263,517324877789
2016-04-15,175,513959169343,25338240194,424461774,1866486619,18578694,515825655962
2016-04-18,174,512273796689,23645109654,437920187,1884974375,34238477,514158771064
2016-04-19,173,512299527727,20853636754,445711924,1895798761,27911578,514195326488
2016-04-20,172,506019596565,33417664759,459026202,1969683025,48540371,507989279590
2016-04-21,171,504729309486,23671067589,455710066,1927995631,25810818,506657305117
2016-04-22,170,501699887412,15483224766,434986489,1837147974,12498910,503537035386
2016-04-25,169,501105836656,14531444301,452977787,1888084518,28658390,502993921174
2016-04-26,168,500229477522,14289114810,452548563,1912955038,26178572,502142432560
2016-04-27,167,499245448785,15286475183,478036407,1959244221,38562964,501204693006
2016-04-28,166,498679671165,16736075918,483917118,1971968247,28580969,500651639412
2016-04-29,165,494455780517,12930112151,465309165,1889693904,14545540,496345474421
2016-05-03,164,498068800143,24446886546,459347061,1916449042,18254554,499985249185
2016-05-04,163,498378241538,21673655978,459179739,1908585250,25394240,500286826788
2016-05-05,162,498647195271,18795254421,443338759,1866740178,19508495,500513935449
2016-05-06,161,493019015948,25206015858,448117885,1821751220,35486769,494840767168
2016-05-09,160,489787952075,18589026402,454084772,1814654742,33873364,491602606817
2016-05-10,159,486770066004,11967954223,465327237,1848438009,31123109,488618504013
2016-05-11,158,484223329354,14605560018,476347184,1908372766,26286230,486131702120
2016-05-12,157,482195898002,14746480437,487960984,1985512603,33452758,484181410605
2016-05-13,156,479835870205,12799334852,465843265,1867654477,15437677,481703524682
2016-05-16,155,479976560380,13682998225,459251370,1865306755,14189483,481841867135
2016-05-17,154,478828511618,15685066169,467485550,1881070331,23463162,480709581949
2016-05-18,153,474780510464,14732885027,465470861,1881965580,35905915,476662476044
2016-05-19,152,474796983383,14160647518,422386820,1744718654,14410300,476541702037
2016-05-20,151,473967145973,14282633644,416942266,1729756848,36595663,475696902821
2016-05-23,150,473790185446,15087136624,422091594,1753543484,31403739,475543728930
2016-05-24,149,474113760053,14061116207,435897186,1798419073,34425332,475912179126
2016-05-25,148,473248745984,13439435439,447111489,1819093057,33450208,475067839041
2016-05-26,147,472502816382,14550761697,449693374,1847415057,38126177,474350231439
2016-05-27,146,470933246425,12946566059,408347779,1693078510,15409047,472626324935
2016-05-30,145,469474286135,12118100614,433400007,1788434447,50249356,471262720582
2016-05-31,144,472770517075,29411838246,399469150,1773404013,33599650,474543921088
2016-06-01,143,473842939459,26853747104,389097930,1733878875,27907000,475576818334
2016-06-02,142,475857307685,22727591932,400678010,1777461682,26956835,477634769367
2016-06-03,141,473956396588,24400622414,400124553,1795161021,35727267,475751557609
2016-06-06,140,474696463629,20389851290,406734589,1807091008,24680932,476503554637
2016-06-07,139,474785801210,18687817684,423323012,1859507222,34423914,476645308432
2016-06-08,138,472230941146,19223668206,425791006,2083247021,49710215,474314188167
2016-06-13,137,470718833261,22065754739,430977947,1764666802,58834669,472483500063
2016-06-14,136,469814782324,14488643361,455743898,2140904265,65977760,471955686589
2016-06-15,135,472774017130,25071419447,444026379,2030176669,60139809,474804193799
2016-06-16,134,472426696313,22911662035,417334456,1842035190,33767428,474268731503
2016-06-17,133,471145006787,22059853838,392024143,1767669480,35213798,472912676267
2016-06-20,132,471899642785,18147176614,400271759,1868935709,33731307,473768578494
2016-06-21,131,471148810549,22369420851,408942965,1907486817,49486834,473056297366
2016-06-22,130,471757473392,18476704112,402136318,1856200904,33557104,473613674296
2016-06-23,129,470989946736,19023254037,431763853,1990896299,53017447,472980843035
2016-06-24,128,469568272060,24668541492,430224808,1888549208,54843576,471456821268
2016-06-27,127,472130992856,23847929426,439742629,1969519019,51126452,474100511875
2016-06-28,126,473172010473,25173695721,414451274,2001696516,40340399,475173706989
2016-06-29,125,475231804471,26788675844,447815442,2118405363,64276454,477350209834
2016-06-30,124,474937137098,21467742218,442419821,2101251811,26303758,477038388909
2016-07-01,123,473366707712,19675919674,434497231,2099563495,35646834,475466271207
2016-07-04,122,477343099023,32130856359,460635630,2302250937,62146625,479645349960
2016-07-05,121,478894481453,32734362701,478227617,2446240005,48180877,481340721458
2016-07-06,120,480194633761,29106028080,491520521,2419211393,43624495,482613845154
2016-07-07,119,480968164323,31988828163,508156060,2487269285,45517665,483455433608
2016-07-08,118,478082382396,23389548398,471563001,2349687842,22199670,480432070238
2016-07-11,117,479342990976,32614662316,479247541,2469632807,55737335,481812623783
2016-07-12,116,482110757617,36821977122,476516057,2549096995,66672703,484659854612
2016-07-13,115,481908335239,36678423531,423099353,2356322937,48346342,484264658176
2016-07-14,114,482059531983,27102641122,418557552,2366026078,43634449,484425558061
2016-07-15,113,481144294514,25326907353,392322171,2244011673,30810932,483388306187
2016-07-18,112,483284066990,26067867176,411505500,2326851515,45236181,485610918505
2016-07-19,111,485650291962,23944297057,411786317,2313343445,44047567,487963635407
2016-07-20,110,486271452106,21205037443,408812651,2339523643,27612751,488610975749
2016-07-21,109,487493320212,25317838648,418468884,2446552497,44999084,489939872709
2016-07-22,108,485774399944,24165846980,396108001,2273696518,35511469,488048096462
2016-07-25,107,486965174977,21623531740,402557515,2265389528,28996966,489230564505
2016-07-26,106,487693941995,23503719129,422853429,2449075034,50838836,490143017029
2016-07-27,105,482124688799,38181156047,438321183,2502229053,76538726,484626917852
2016-07-28,104,480421749174,26674128603,430378718,2485031794,51024068,482906780968
2016-07-29,103,478048309022,19644960366,412096456,2373197134,24671710,480421506156
2016-08-01,102,476355670754,18019034247,418461422,2352431485,40136631,478708102239
2016-08-02,101,476393053057,14878698033,411015899,2350121715,28426603,478743174772
2016-08-03,100,476932091555,18468077204,434926411,2460715830,51204670,479392807385
2016-08-04,99,477637950967,18769312405,445576381,2512008832,44262829,480149959799
2016-08-05,98,476692801710,18678111692,441467482,2474642813,40057237,479167444523
2016-08-08,97,477819998514,21430172220,462116396,2615946503,50381630,480435945017
2016-08-09,96,479047204988,22848524757,460717073,2643024561,54921971,481690229549
2016-08-10,95,480718943503,22612841898,482661441,2736885063,53461075,483455828566
2016-08-11,94,480775762109,22024349627,487745002,2772890637,50664908,483548652746
2016-08-12,93,479839424564,22006966793,465115409,2705740435,56541175,482545164999
2016-08-15,92,486485232335,45599596654,456701529,2883440312,92273965,489368672647
2016-08-16,91,493566088751,41889657998,425996915,2754629970,63014807,496320718721
2016-08-17,90,495659051254,32177481153,411112441,2685725798,40993272,498344777052
2016-08-18,89,498543748648,35091631592,403174145,2638732511,41562691,501182481159
2016-08-19,88,498282428488,28438491033,420104549,2677317602,73765265,500959746090
2016-08-22,87,499145177131,27494751512,428532762,2738433455,43399057,501883610586
2016-08-23,86,499734417220,23174573771,442672350,2793503662,57331203,502527920882
2016-08-24,85,500400801436,20520998519,437582114,2753149425,47004479,503153950861
2016-08-25,84,500791792381,23464991931,440284911,2748060930,53762538,503539853311
2016-08-26,83,499937745356,20244740587,413193125,2648511173,34680854,502586256529
2016-08-29,82,501477435834,19262597443,433383078,2723176228,52040537,504200612062
2016-08-30,81,501004637549,18127747375,459464394,2942132684,68741513,503946770233
2016-08-31,80,501716007963,20539638820,445541370,2972281463,54635530,504688289426
2016-09-01,79,501535695782,20956719333,464663438,3021949312,61126202,504557645094
2016-09-02,78,499592197550,19720914539,477936580,3055378796,75347741,502647576346
2016-09-05,77,500516748119,19738718257,470316954,2926669963,58457638,503443418082
2016-09-06,76,503013816371,24868965139,466174782,2942855884,55852469,505956672255
2016-09-07,75,503273563343,25787343636,486415126,3021243613,58620249,506294806956
2016-09-08,74,503708906192,19861671600,464077236,2941733401,31236471,506650639593
2016-09-09,73,501701136676,21402589584,456713699,2887751901,34540563,504588888577
2016-09-12,72,499740145178,25293646673,465709861,2893896356,66451677,502634041534
2016-09-13,71,499635099269,18045851868,426244384,2715487728,30621776,502350586997
2016-09-14,70,496229314357,15678069181,399261828,2560130168,33751163,498789444525
2016-09-19,69,497965398653,15970987319,458113075,2886141226,97715212,500851539879
2016-09-20,68,498636196708,15176233151,448011985,2789447018,46584823,501425643726
2016-09-21,67,498866810752,14949437717,446683649,2786995059,45304902,501653805811
2016-09-22,66,497769188223,18424362327,449913652,2842252320,40987349,500611440543
2016-09-23,65,495548458994,15777430126,443885874,2757532261,36732719,498305991255
2016-09-26,64,495311007534,18398310421,476130925,2921256301,79824556,498232263835
2016-09-27,63,494949863817,14803735855,462171998,2904498020,52782678,497854361837
2016-09-28,62,493935142585,12346963447,449641915,2761111210,35129214,496696253795
2016-09-29,61,492459294682,13966699339,397543343,2559643250,30521234,495018937932
2016-09-30,60,485368046034,10947748818,363099308,2302076042,8089909,487670122076
2016-10-10,59,490131918314,23559668411,375738521,2485754138,51608471,492617672452
2016-10-11,58,493155823819,23454512182,418551097,2815512031,77300340,495971335850
2016-10-12,57,495554017689,18404348514,406734625,2690801688,36990083,498244819377
2016-10-13,56,497309822724,20303030805,438553008,3013468547,66699273,500323291271
2016-10-14,55,496412883860,19548242666,422481098,2891899790,44694709,499304783650
2016-10-17,54,498028728910,22216720236,420388098,2866511869,62002962,500895240779
2016-10-18,53,501292033743,25202934394,392963150,2805307720,56407223,504097341463
2016-10-19,52,502224582657,24632359171,402945727,2818854308,54739907,505043436965
2016-10-20,51,502719680826,20264716528,396722645,2786501246,35699000,505506182072
2016-10-21,50,502362504192,24048546481,419385750,2929633779,67679796,505292137971
2016-10-24,49,506651209666,31973297399,433450220,3062310997,71104158,509713520663
2016-10-25,48,509481313469,28013985325,399692664,2938692369,31563950,512420005838
2016-10-26,47,511241718608,26837389154,446092326,3047214321,76024903,514288932929
2016-10-27,46,512147647095,22057706294,394421882,2867404567,29135306,515015051662
2016-10-28,45,508646408411,23432607213,414787502,2942339368,65997917,511588747779
2016-10-31,44,510247896561,19877461369,394882433,2889058916,44174035,513136955477
2016-11-01,43,512090091838,22527066066,405192780,2980140097,47955298,515070231935
2016-11-02,42,512202186235,25005871992,405074419,2978091658,45269483,515180277893
2016-11-03,41,516372674587,35185628006,432318559,3185394756,75471916,519558069343
2016-11-04,40,515916361686,27702389256,412984066,3027101051,48299358,518943462737
2016-11-07,39,517199830196,25675769223,442842002,3167668799,71740701,520367498995
2016-11-08,38,517880324403,27167238686,462988347,3333262968,84189547,521213587371
2016-11-09,37,520589849944,35512155182,462410746,3192679339,82817210,523782529283
2016-11-10,36,524100406163,35916279752,486231069,3430919078,93839585,527531325241
2016-11-11,35,524606038523,43717351669,482698727,3451229128,84919692,528057267651
2016-11-14,34,530434954651,47161377775,496669558,3455894457,99913739,533890849108
2016-11-15,33,532962827325,35512135262,476691015,3515075241,68217977,536477902566
2016-11-16,32,535701347651,31599321935,482953798,3369798586,72436987,539071146237
2016-11-17,31,536057751317,29092021043,519016876,3591333097,91203935,539649084414
2016-11-18,30,535057333809,28680837457,505681128,3342644447,82417417,538399978256
2016-11-21,29,538823020390,32816415500,510095248,3515686889,91673033,542338707279
2016-11-22,28,542008130531,37589023793,542024944,3586448687,106051188,545594579218
2016-11-23,27,541686542434,35396629202,526193407,3586996836,74331524,545273539270
2016-11-24,26,541913908842,33906643087,567936112,3824549910,106844753,545738458752
2016-11-25,25,541073208543,34030570478,501453341,3584196203,63936966,544657404746
2016-11-28,24,546721796406,41134076209,572810333,3889652394,129391632,550611448800
2016-11-29,23,550196731263,49413534718,544702721,3827897378,94585947,554024628641
2016-11-30,22,553319387731,38009703417,506692809,3623238146,50799789,556942625877
2016-12-01,21,555785149855,36512524580,552004472,3841995830,100266615,559627145685
2016-12-02,20,552942591967,37792654678,495343851,3646377298,68000163,556588969265
2016-12-05,19,552584304283,32964380204,503114693,3459620852,100734285,556043925135
2016-12-06,18,552796495709,22502287281,486530914,3420881587,83049594,556217377296
2016-12-07,17,553519950153,24070429642,489271972,3533985798,83557693,557053935951
2016-12-08,16,554108985855,23898531152,519305685,3692335096,95894711,557801320951
2016-12-09,15,552842108711,26820353251,538778789,3669446342,93808717,556511555053
2016-12-12,14,545636500112,31162678070,517859220,3579624571,83839951,549216124683
2016-12-13,13,545857484973,21736669175,457275910,3258606848,67786023,549116091821
2016-12-14,12,547536309834,26484861643,465077218,3253930817,80933727,550790240651
2016-12-15,11,549415404110,24392317065,443548145,3081793935,81333331,552497198045
2016-12-16,10,547544828889,18239764248,412000314,2939297065,56281638,550484125954
2016-12-19,9,547210251108,18200653755,403906740,2929726450,65519502,550139977558
2016-12-20,8,548400035764,18737420154,392934181,2862197707,59466063,551262233471
2016-12-21,7,549096724136,22122050674,402364088,3096966389,92112448,552193690525
2016-12-22,6,548638718046,19296334236,420642645,2961458772,92968466,551600176818
2016-12-23,5,544894505934,19043031252,400283208,2956020933,59553988,547850526867
2016-12-26,4,545743760642,19619483085,418642842,2897953730,92797165,548641714372
2016-12-27,3,546989121102,17809785774,375557145,2771776523,35705009,549760897625
2016-12-28,2,547380152489,16009398832,382417435,2630404190,55373111,550010556679
2016-12-29,1,546781977610,15751094213,374559216,2670847647,57849241,549452825257
2016-12-30,0,541744074134,14344231540,445295507,2907720287,120410464,544651794421
2017-01-03,9,541086585301,16133800643,396621694,2751779090,60364739,543838364391
2017-01-04,8,540266946445,19600153246,411284970,2827996656,77535673,543094943101
2017-01-05,7,539549321455,19822922714,432558412,2988885418,73640617,542538206873
2017-01-06,6,537500878600,19869471573,418582234,2858333974,58039504,540359212574
2017-01-09,5,537718895628,20095812115,451035138,3151701673,91852042,540870597301
2017-01-10,4,536648846867,20212691796,466512102,3159415794,93465888,539808262661
2017-01-11,3,535042445743,18902724719,464150097,3257103313,89826296,538299549056
2017-01-12,2,533756166491,15745649736,449814088,3147374871,63277969,536903541362
2017-01-13,1,528892909817,14808474716,434442382,3147160699,52882035,532040070516
2017-01-16,0,516166619858,18744123693,468408987,3366270199,89447836,519532890057
