,opDate,rzye,rzmre,rqyl,rqylje,rqmcl,rzrqjyzl
0,2014-12-31,690304859709,80629221496,1033591309,6213794573,1501441714,696518654282
1,2014-12-30,691781993774,76341827158,956068448,5620343498,1410191883,697402337272
2,2014-12-29,687678463441,102445925919,921606454,5485660125,1498505294,693164123566
3,2014-12-26,678646298701,87566428865,908219276,5392786771,1569099080,684039085472
4,2014-12-25,672974233665,66548637889,884652636,5075978446,1692348394,678050212111
5,2014-12-24,667220851499,60785434137,783877016,4423264212,1386061393,671644115711
6,2014-12-23,669005263570,68088717135,847853767,4905506876,1286459935,673910770446
7,2014-12-22,670595742509,96086844112,890122025,5146324106,1413056150,675742066615
8,2014-12-19,667260348402,87986460410,859906608,4990159015,1622112746,672250507417
9,2014-12-18,657356997782,86108084304,872698179,5116335254,1566415717,662473333036
10,2014-12-17,648449628389,105662386619,865219858,5036994474,1821400330,653486622863
11,2014-12-16,637958256722,92376303515,853613379,4957962271,1765606520,642916218993
12,2014-12-15,628731166297,76617552763,814475178,4669814929,1349573360,633400981226
13,2014-12-12,619376064853,73760055817,815521523,4628969709,1325624254,624005034562
14,2014-12-11,617381768756,81319089922,854689464,4817034195,1443866814,622198802951
15,2014-12-10,614042935191,92619534535,841858350,4845585561,1616220166,618888520752
16,2014-12-09,605492638583,121843297582,914927637,5039482033,1591762695,610532120616
17,2014-12-08,595995563719,114513688894,995831230,5686867709,1709393286,601682431428
18,2014-12-05,575483801438,113474295457,892615083,5035049577,1540867053,580518851015
19,2014-12-04,569429142951,105227574155,941956620,5252685856,1573490018,574681828807
20,2014-12-03,552052549201,99700572568,903194391,4791756429,1448412944,556844305630
21,2014-12-02,545712569004,76886420448,923073399,4828937503,1541232526,550541506507
22,2014-12-01,538392930415,77440824794,921040710,4568075249,1378086937,542961005664
23,2014-11-28,528992449890,77397865373,889100209,4426133104,1491509405,533418582994
24,2014-11-27,522913808670,67309594520,805062141,4099983450,1303976656,527013792120
25,2014-11-26,518602496677,67013032917,755040399,3830675045,1220782039,522433171722
26,2014-11-25,509781678532,59098287139,700758902,3601461778,1196315299,513383140310
27,2014-11-24,499260287798,69936096428,662448084,3450542062,1453456183,502710829860
28,2014-11-21,485787498700,37965320439,669336273,3334098780,1042151760,489121597480
29,2014-11-20,483384872787,26772643084,695967139,3367936291,868061627,486752809078
30,2014-11-19,481691069603,29457074491,665399210,3264178092,892735104,484955247695
31,2014-11-18,479387054532,30864025290,671129141,3318621527,841441801,482705676059
32,2014-11-17,476797912474,33657280576,758355649,3685735609,796147149,480483648083
33,2014-11-14,474451979124,33685785420,809489891,3805366969,859203537,478257346093
34,2014-11-13,474102238964,47038257972,845053146,3918633272,1089309031,478020872236
35,2014-11-12,471792706194,38069159328,832982089,3882134761,1093428955,475674840955
36,2014-11-11,468511764722,59512181726,800379944,3677941190,1203971043,472189705912
37,2014-11-10,464090522420,43074937834,827763105,3775253288,1208677572,467865775708
38,2014-11-07,460794750926,43096954614,653784032,3151991170,1139240456,463946742096
39,2014-11-06,460287164514,31786397981,622440545,3071093972,883170931,463358258486
40,2014-11-05,456679655698,35525776693,650164593,3175028313,935088084,459854684011
41,2014-11-04,453445058673,39878215488,647859142,3196509968,955937193,456641568641
42,2014-11-03,449802419175,41008787115,648973897,3221660705,992203255,453024079880
43,2014-10-31,444331032561,42922083624,644906244,3139694050,1093918443,447470726611
44,2014-10-30,443442891214,39726432779,571062165,2863055358,1049889692,446305946572
45,2014-10-29,439652493432,37671197598,479029360,2611824795,943217116,442264318227
46,2014-10-28,440302363994,27452149524,404811012,2314768155,893030334,442617132149
47,2014-10-27,441744151692,20724534608,332511522,1996485943,799180180,443740637635
48,2014-10-24,439035804092,20161466320,372718592,2199412318,720012033,441235216410
49,2014-10-23,436985726360,25192335627,408886028,2340514878,817182870,439326241238
50,2014-10-22,432871031115,24355603992,494400773,2693781267,822328450,435564812382
51,2014-10-21,430306864259,24884170638,536925943,2802116786,713476074,433108981045
52,2014-10-20,427824766563,23487001573,537157389,2824265997,748585888,430649032560
53,2014-10-17,425311288395,29063327336,487718729,2654957393,743205694,427966245788
54,2014-10-16,424530873677,35283134771,585040803,3010510230,931306322,427541383907
55,2014-10-15,422266917101,31845671858,552337971,2885487467,774764311,425152404568
56,2014-10-14,417913475124,30016767013,534018157,2752285172,783993509,420665760296
57,2014-10-13,413817989559,31602674452,519860635,2684864566,749586286,416502854125
58,2014-10-10,407459730065,34135897574,536135153,2772753535,768465628,410232483600
59,2014-10-09,403598187437,36582698297,547404751,2858754154,811258045,406456941591
60,2014-10-08,397396842118,37442090357,559818258,2836409256,923699622,400233251374
61,2014-09-30,386227534354,27147344071,447007098,2402153637,672778691,388629687991
62,2014-09-29,393042488212,28613142315,507492826,2644410326,757653472,395686898538
63,2014-09-26,395131055448,27354261183,519168328,2654825242,850494322,397785880690
64,2014-09-25,393151191091,35791324236,488477394,2618340050,904722652,395769531141
65,2014-09-24,388077718595,35224990253,516421911,2717092663,1100530763,390794811258
66,2014-09-23,380499940014,22613124910,476327632,2580377167,851878416,383080317181
67,2014-09-22,377641662610,26802465503,444658130,2472695378,611299373,380114357988
68,2014-09-19,371414736256,23437077528,505039270,2743342013,779322832,374158078269
69,2014-09-18,371022528916,23454655704,515412100,2754050358,910651338,373776579274
70,2014-09-17,368035491871,24747959534,481116386,2633272090,759755012,370668763961
71,2014-09-16,364561939383,38576347008,494045733,2675808937,882829505,367237748320
72,2014-09-15,360155185805,30277233230,493654518,2786068344,741223637,362941254149
73,2014-09-12,354592937514,25877300283,524061365,2854744948,677360994,357447682462
74,2014-09-11,351356901278,31551508007,508336149,2809839184,813463327,354166740462
75,2014-09-10,347084945437,26516564784,524305237,2844850067,689374080,349929795504
76,2014-09-09,342444319645,29429506399,604878031,3157574813,674256665,345601894458
77,2014-09-05,337114774267,27435309267,607844092,3167707067,718005670,340282481334
78,2014-09-04,337616642418,27868392314,557972740,2987580074,631924778,340604222492
79,2014-09-03,334451881572,28142266923,510673136,2802271135,754505396,337254152707
80,2014-09-02,334304257645,25074482942,459853238,2575067297,748140249,336879324942
81,2014-09-01,334993392377,19375199451,420833944,2353464222,526996495,337346856599
82,2014-08-29,333028014188,14869789058,427854960,2336768882,584884633,335364783070
83,2014-08-28,331974283614,18075448159,416710514,2306178645,647097944,334280462259
84,2014-08-27,327033468171,15775159716,466948496,2506072682,621260285,329539540853
85,2014-08-26,324639044384,19645912134,477910818,2545234947,514061085,327184279331
86,2014-08-25,322692875254,20660713907,525815421,2712634191,621002441,325405509445
87,2014-08-22,320712615102,20931605475,539562024,2777758609,558178032,323490373711
88,2014-08-21,319781417111,20937372387,522418447,2783449809,520977083,322564866920
89,2014-08-20,316919893355,21102254552,559844185,2952936920,585841603,319872830275
90,2014-08-19,314000082686,24478938058,558964767,2971229057,651976796,316971311743
91,2014-08-18,311144915581,22116914462,545878941,2928628202,523299838,314073543783
92,2014-08-15,308505667412,19882847811,549070930,2926728670,648326303,311432396082
93,2014-08-14,307293179271,21440618954,537777146,2848463783,524203849,310141643054
94,2014-08-13,304160550816,22784891797,549787632,2941328293,552469178,307101879109
95,2014-08-12,300455598098,20662634626,566152801,2993821657,519066175,303449419755
96,2014-08-11,297415010530,19756935325,595874736,3098591058,628749710,300513601588
97,2014-08-08,295837518089,16839331892,511141987,2739068954,457482616,298576587043
98,2014-08-07,294718230086,21831148630,553475703,2880806829,503910514,297599036915
99,2014-08-06,291615855527,22133809226,718356226,3394814354,600292309,295010669881
100,2014-08-05,288090413294,21974257920,646019448,3367752810,535884671,291458166104
101,2014-08-04,285698012007,21361247609,669994503,3494808384,622623693,289192820391
102,2014-08-01,282807951055,20877644942,604541045,3183147027,499792345,285991098082
103,2014-07-31,283472878022,19428333365,637597008,3299144167,562002156,286772022189
104,2014-07-30,281191829508,21820828528,621204665,3224125568,526037245,284415955076
105,2014-07-29,277436563438,22313772448,643909616,3273443034,570960875,280710006472
106,2014-07-28,275792314276,25330816505,602367464,3096334488,837980913,278888648764
107,2014-07-25,276338715895,16146244265,485628190,2609137766,653919936,278947853661
108,2014-07-24,277337816759,19341209261,480781456,2523214638,781324478,279861031397
109,2014-07-23,275745037661,15381414613,408977710,2215194858,608947146,277960232519
110,2014-07-22,273882387833,14498460951,420753681,2198534959,673156369,276080922792
111,2014-07-21,272800679038,10107133251,395796666,2153674887,414377242,274954353925
112,2014-07-18,273067071370,10487979224,363760230,2050709730,449770806,275117781100
113,2014-07-17,274021765613,10449050940,348209476,2020042857,364431807,276041808470
114,2014-07-16,273677477762,13832170116,368431573,2024579463,550544268,275702057225
115,2014-07-15,272382809571,13649257521,335855032,1887331655,449671396,274270141226
116,2014-07-14,271692944012,14022448475,320726698,1819218966,491241717,273512162978
117,2014-07-11,270336177205,11432852766,304315056,1743881323,387263768,272080058528
118,2014-07-10,270150328048,11445433593,312335779,1789239958,438918350,271939568006
119,2014-07-09,268976908835,13708146360,321895785,1837924169,442627206,270814833004
120,2014-07-08,267771059963,11443120248,356328337,1941623111,431865953,269712683074
121,2014-07-07,266651924011,11498589639,360983132,1964318103,459386341,268616242114
122,2014-07-04,265436852269,11209332181,351429329,1909107890,457240169,267345960159
123,2014-07-03,265974898727,13478521704,354317677,1920076729,596042331,267894975456
124,2014-07-02,265240147977,12502321252,321647158,1804553417,511541725,267044701394
125,2014-07-01,264607937184,11619124167,299236702,1728225591,328687972,266336162775
126,2014-06-30,263735543924,11863350290,366129787,1864005213,571830221,265599549137
127,2014-06-27,262843748934,10674745540,301262117,1670352288,567235752,264514101222
128,2014-06-26,263901777459,8934494319,291804496,1705964326,427774674,265607741785
129,2014-06-25,264826122031,7798911904,284059871,1729313567,386524893,266555435598
130,2014-06-24,264557736440,8678669140,298013493,1783361767,444842281,266341098207
131,2014-06-23,264423995477,7984521565,268562075,1711404991,509041591,266135400468
132,2014-06-20,264462000733,7311573935,256773555,1659092486,455954978,266121093219
133,2014-06-19,264416711355,11575621771,272158884,1692954281,471621209,266109665636
134,2014-06-18,263464984389,10981607193,327078543,1905445146,596836596,265370429535
135,2014-06-17,261262566962,10678375115,347794481,1986059991,445866109,263248626953
136,2014-06-16,259830180798,10960047052,383097959,2128107268,554372917,261958288066
137,2014-06-13,259234464249,11035429772,330619081,1932557952,526948093,261167022201
138,2014-06-12,260095159980,9619440443,313294537,1880328796,389478460,261975488776
139,2014-06-11,259331157651,9242894688,313315711,1902826720,418877395,261233984371
140,2014-06-10,258915454209,9738387204,330908321,1925383864,495122774,260840838073
141,2014-06-09,258813086318,7991678955,295477968,1790513118,468188414,260603599436
142,2014-06-06,258783819562,7841012896,262974892,1676569971,346320349,260460389533
143,2014-06-05,258996504218,7718020196,294637183,1793129953,383802206,260789634171
144,2014-06-04,259577930516,8028118877,271997131,1702384698,395633241,261280315214
145,2014-06-03,259934197396,8771506084,291677668,1785620918,481673233,261719818314
146,2014-05-30,260267422226,8167969061,270315721,1702233281,393229868,261969655507
147,2014-05-29,261867723917,9774455584,288072807,1773432798,402510032,263641156715
148,2014-05-28,262495558871,10723796154,312371350,1849684934,478352223,264345243805
149,2014-05-27,262184505749,8449243396,294368537,1786177552,464635704,263970683301
150,2014-05-26,261798286090,8649747489,289836117,1769480155,435522588,263567766245
151,2014-05-23,262179721956,7232471152,289470665,1742951754,421775919,263922673710
152,2014-05-22,263285667241,8451473422,293952400,1758195332,411065463,265043862573
153,2014-05-21,263711250561,7437968535,290253832,1769018748,554334184,265480269309
154,2014-05-20,263329869576,7378819909,264519437,1660684994,407006502,264990554570
155,2014-05-19,262978461564,8257521627,256420841,1636149807,411757235,264614611371
156,2014-05-16,262504748253,6777228354,254283436,1674467649,358331263,264179215902
157,2014-05-15,263365496848,8055799282,261473338,1714345106,436143161,265079841954
158,2014-05-14,263785295626,7703544903,302805472,1827570230,376333959,265612865856
159,2014-05-13,263875665230,10210290975,300233901,1857824098,341660691,265733489328
160,2014-05-12,263336148453,12716672910,316539590,1887908530,517233276,265224056983
161,2014-05-09,262894808767,7334172832,263259050,1705756394,409249410,264600565161
162,2014-05-08,263640476055,7985052061,294182863,1789704684,378944870,265430180739
163,2014-05-07,263849484060,7547560079,291050868,1783931061,433098190,265633415121
164,2014-05-06,263870108487,8424672721,291324162,1790872794,485860492,265660981281
165,2014-05-05,263125449389,8516572164,279157134,1728998220,437716918,264854447609
166,2014-04-30,262009980050,7247352226,248958249,1635791841,321016213,263645771891
167,2014-04-29,263634326264,7772909913,264533302,1691287829,463996527,265325614093
168,2014-04-28,264627794987,8967146941,257761033,1613005629,428957376,266240800616
169,2014-04-25,265576759765,9783865720,290233116,1721207938,398306780,267297967703
170,2014-04-24,266725968953,8580516470,348963789,1905803549,422788291,268631772502
171,2014-04-23,267460402473,8985208087,325476173,1860871023,431177873,269321273496
172,2014-04-22,266870388802,11267977775,305325870,1799916359,498582898,268670305161
173,2014-04-21,266692676276,11210339116,301789768,1769176200,477960722,268461852476
174,2014-04-18,266499969446,9577431792,287242016,1794892129,374983845,268294861575
175,2014-04-17,266776778235,10134509283,330355879,1934603170,324658411,268711381405
176,2014-04-16,266555259816,10267873861,330635368,1975243309,362009563,268530503125
177,2014-04-15,266244836275,13534438812,314794767,1903452565,294872317,268148288840
178,2014-04-14,264564175463,12074556314,367306449,2121974869,367334437,266686150332
179,2014-04-11,262883689026,14611841647,384965781,2175945347,436033396,265059634373
180,2014-04-10,262944130727,19699552948,395589445,2251706479,579654220,265195837206
181,2014-04-09,260538989557,12507535371,340435478,2046832746,378482964,262585822303
182,2014-04-08,259332941260,15064019071,379430465,2142303390,677734271,261475244650
183,2014-04-04,258587521605,8204649460,323644312,1915929285,386841831,260503450890
184,2014-04-03,259439552720,10708696243,338802278,1951085811,515881175,261390638531
185,2014-04-02,258348609225,9776632960,357172759,2028112154,509755055,260376721379
186,2014-04-01,258455252144,7454147839,329582717,1882870067,299476363,260338122211
187,2014-03-31,258890954278,8313336207,315372340,1788598988,320555736,260679553266
188,2014-03-28,259105897661,10963018786,322624543,1781791692,351554903,260887689353
189,2014-03-27,260095867854,12509484624,341174945,1858453331,527446678,261954321185
190,2014-03-26,259400663608,10473570962,365487641,1927608947,375383768,261328272555
191,2014-03-25,258315904924,12745301869,359963463,1903062121,419892694,260218967045
192,2014-03-24,257147141519,14887597993,358982196,1905006670,534188976,259052148189
193,2014-03-21,255770666920,14222628366,306673488,1740051312,694067021,257510718232
194,2014-03-20,255559503792,10997485798,390205441,1946992062,408416362,257506495854
195,2014-03-19,255575562621,10216100311,449441334,2053149380,329802162,257628712001
196,2014-03-18,254150400180,11016382497,488658181,2153234090,307781284,256303634270
197,2014-03-17,253043587759,9484884772,492981307,2184786624,346139134,255228374383
198,2014-03-14,252331071010,8951176202,488064245,2151721772,289536899,254482792782
199,2014-03-13,252761075051,10331280705,483937455,2192453531,516236308,254953528582
200,2014-03-12,251945854288,10131458341,422673168,1997247313,519314091,253943101601
201,2014-03-11,252038649300,9244370725,388371182,1917867637,518475094,253956516937
202,2014-03-10,252414971026,11738421987,362900252,1830208829,449345548,254245179855
203,2014-03-07,253050872759,11198350419,304513619,1793411804,350246872,254844284563
204,2014-03-06,253730966768,11798471888,276332011,1704549281,447122447,255435516049
205,2014-03-05,253240132979,11196972813,299624044,1750662801,364577596,254990795780
206,2014-03-04,252351780621,12125200646,291377717,1699560915,419070658,254051341536
207,2014-03-03,251983073596,12657075837,279935937,1677166495,414288005,253660240091
208,2014-02-28,250685575955,11898490852,249070155,1590875805,453430707,252276451760
209,2014-02-27,250675886815,13592753313,269433840,1624211532,576954165,252300098347
210,2014-02-26,250664112715,11539038673,221440769,1410092409,413732928,252074205124
211,2014-02-25,249672061830,15187411554,215305068,1436846056,409132399,251108907886
212,2014-02-24,250050968636,13189674622,216281062,1480014536,420273062,251530983172
213,2014-02-21,249701725590,12045784878,237719811,1549862047,303760600,251251587637
214,2014-02-20,249861080842,16705939916,270187624,1702618265,485700886,251563699107
215,2014-02-19,248756501420,16467807361,263589732,1710771073,544344331,250467272493
216,2014-02-18,246823602738,16987912093,215374452,1524191379,521044568,248347794117
217,2014-02-17,244480638839,16297930378,234841562,1609881723,351927197,246090520562
218,2014-02-14,242428321403,11422214895,228509451,1540651251,288082468,243968972654
219,2014-02-13,242214544627,16575349032,254394920,1598740564,484546617,243813285191
220,2014-02-12,239798698269,14427258810,238999956,1556251316,444801939,241354949585
221,2014-02-11,237113578259,17047728070,252608067,1588789186,529137869,238702367445
222,2014-02-10,233894222460,15675885762,225887393,1481220821,427008003,235375443281
223,2014-02-07,230299148177,10055176584,172647885,1303402675,303879043,231602550852
224,2014-01-30,227890201770,7046396520,152716226,1158623034,207762324,229048824804
225,2014-01-29,230617999048,8042093293,185304033,1337871390,208615454,231955870438
226,2014-01-28,231923649468,7893789417,187152618,1349330588,255296701,233272980056
227,2014-01-27,232466131188,10823464032,183628045,1323031454,288632280,233789162642
228,2014-01-24,231774564282,10368793788,190789333,1391626771,362572139,233166191053
229,2014-01-23,231945821615,10130547148,220619872,1495065117,280726467,233440886732
230,2014-01-22,231326049737,10873150808,264444360,1619788087,392040765,232945837824
231,2014-01-21,230777571850,6968031351,217439214,1502450099,308110357,232280021949
232,2014-01-20,230791913661,5607296766,212692229,1499170924,239283326,232291084585
233,2014-01-17,230412377549,6844410935,216779452,1526453295,281672856,231938830844
234,2014-01-16,230060965821,7656168912,239050510,1627160554,329057994,231688126375
235,2014-01-15,229811843792,7343289231,234939151,1597822610,332330199,231409666402
236,2014-01-14,229311743389,6685515130,241626323,1608590091,362113144,230920333480
237,2014-01-13,229499201270,6346364908,229413614,1568228234,462661185,231067429504
238,2014-01-10,229737294553,7004169454,231295830,1537336124,319225435,231274630677
239,2014-01-09,230020088540,8847269593,238660143,1593767536,413420487,231613856076
240,2014-01-08,229156113820,7463940724,242021069,1636238245,389624522,230792352065
241,2014-01-07,228638358705,5910246628,235286454,1583705720,368645925,230222064425
242,2014-01-06,228761343756,8036279087,215850289,1523790712,329112079,230285134468
243,2014-01-03,228595221625,8292729532,214560754,1513927862,305042145,230109149487
244,2014-01-02,228710320652,7318939312,224484301,1557077302,266695937,230267397954
