,opDate,rzye,rzmre,rqyl,rqylje,rqmcl,rzrqjyzl
0,2016-12-30,541744074134,14344231540,445295507,2907720287,120410464,544651794421
1,2016-12-29,546781977610,15751094213,374559216,2670847647,57849241,549452825257
2,2016-12-28,547380152489,16009398832,382417435,2630404190,55373111,550010556679
3,2016-12-27,546989121102,17809785774,375557145,2771776523,35705009,549760897625
4,2016-12-26,545743760642,19619483085,418642842,2897953730,92797165,548641714372
5,2016-12-23,544894505934,19043031252,400283208,2956020933,59553988,547850526867
6,2016-12-22,548638718046,19296334236,420642645,2961458772,92968466,551600176818
7,2016-12-21,549096724136,22122050674,402364088,3096966389,92112448,552193690525
8,2016-12-20,548400035764,18737420154,392934181,2862197707,59466063,551262233471
9,2016-12-19,547210251108,18200653755,403906740,2929726450,65519502,550139977558
10,2016-12-16,547544828889,18239764248,412000314,2939297065,56281638,550484125954
11,2016-12-15,549415404110,24392317065,443548145,3081793935,81333331,552497198045
12,2016-12-14,547536309834,26484861643,465077218,3253930817,80933727,550790240651
13,2016-12-13,545857484973,21736669175,457275910,3258606848,67786023,549116091821
14,2016-12-12,545636500112,31162678070,517859220,3579624571,83839951,549216124683
15,2016-12-09,552842108711,26820353251,538778789,3669446342,93808717,556511555053
16,2016-12-08,554108985855,23898531152,519305685,3692335096,95894711,557801320951
17,2016-12-07,553519950153,24070429642,489271972,3533985798,83557693,557053935951
18,2016-12-06,552796495709,22502287281,486530914,3420881587,83049594,556217377296
19,2016-12-05,552584304283,32964380204,503114693,3459620852,100734285,556043925135
20,2016-12-02,552942591967,37792654678,495343851,3646377298,68000163,556588969265
21,2016-12-01,555785149855,36512524580,552004472,3841995830,100266615,559627145685
22,2016-11-30,553319387731,38009703417,506692809,3623238146,50799789,556942625877
23,2016-11-29,550196731263,49413534718,544702721,3827897378,94585947,554024628641
24,2016-11-28,546721796406,41134076209,572810333,3889652394,129391632,550611448800
25,2016-11-25,541073208543,34030570478,501453341,3584196203,63936966,544657404746
26,2016-11-24,541913908842,33906643087,567936112,3824549910,106844753,545738458752
27,2016-11-23,541686542434,35396629202,526193407,3586996836,74331524,545273539270
28,2016-11-22,542008130531,37589023793,542024944,3586448687,106051188,545594579218
29,2016-11-21,538823020390,32816415500,510095248,3515686889,91673033,542338707279
30,2016-11-18,535057333809,28680837457,505681128,3342644447,82417417,538399978256
31,2016-11-17,536057751317,29092021043,519016876,3591333097,91203935,539649084414
32,2016-11-16,535701347651,31599321935,482953798,3369798586,72436987,539071146237
33,2016-11-15,532962827325,35512135262,476691015,3515075241,68217977,536477902566
34,2016-11-14,530434954651,47161377775,496669558,3455894457,99913739,533890849108
35,2016-11-11,524606038523,43717351669,482698727,3451229128,84919692,528057267651
36,2016-11-10,524100406163,35916279752,486231069,3430919078,93839585,527531325241
37,2016-11-09,520589849944,35512155182,462410746,3192679339,82817210,523782529283
38,2016-11-08,517880324403,27167238686,462988347,3333262968,84189547,521213587371
39,2016-11-07,517199830196,25675769223,442842002,3167668799,71740701,520367498995
40,2016-11-04,515916361686,27702389256,412984066,3027101051,48299358,518943462737
41,2016-11-03,516372674587,35185628006,432318559,3185394756,75471916,519558069343
42,2016-11-02,512202186235,25005871992,405074419,2978091658,45269483,515180277893
43,2016-11-01,512090091838,22527066066,405192780,2980140097,47955298,515070231935
44,2016-10-31,510247896561,19877461369,394882433,2889058916,44174035,513136955477
45,2016-10-28,508646408411,23432607213,414787502,2942339368,65997917,511588747779
46,2016-10-27,512147647095,22057706294,394421882,2867404567,29135306,515015051662
47,2016-10-26,511241718608,26837389154,446092326,3047214321,76024903,514288932929
48,2016-10-25,509481313469,28013985325,399692664,2938692369,31563950,512420005838
49,2016-10-24,506651209666,31973297399,433450220,3062310997,71104158,509713520663
50,2016-10-21,502362504192,24048546481,419385750,2929633779,67679796,505292137971
51,2016-10-20,502719680826,20264716528,396722645,2786501246,35699000,505506182072
52,2016-10-19,502224582657,24632359171,402945727,2818854308,54739907,505043436965
53,2016-10-18,501292033743,25202934394,392963150,2805307720,56407223,504097341463
54,2016-10-17,498028728910,22216720236,420388098,2866511869,62002962,500895240779
55,2016-10-14,496412883860,19548242666,422481098,2891899790,44694709,499304783650
56,2016-10-13,497309822724,20303030805,438553008,3013468547,66699273,500323291271
57,2016-10-12,495554017689,18404348514,406734625,2690801688,36990083,498244819377
58,2016-10-11,493155823819,23454512182,418551097,2815512031,77300340,495971335850
59,2016-10-10,490131918314,23559668411,375738521,2485754138,51608471,492617672452
60,2016-09-30,485368046034,10947748818,363099308,2302076042,8089909,487670122076
61,2016-09-29,492459294682,13966699339,397543343,2559643250,30521234,495018937932
62,2016-09-28,493935142585,12346963447,449641915,2761111210,35129214,496696253795
63,2016-09-27,494949863817,14803735855,462171998,2904498020,52782678,497854361837
64,2016-09-26,495311007534,18398310421,476130925,2921256301,79824556,498232263835
65,2016-09-23,495548458994,15777430126,443885874,2757532261,36732719,498305991255
66,2016-09-22,497769188223,18424362327,449913652,2842252320,40987349,500611440543
67,2016-09-21,498866810752,14949437717,446683649,2786995059,45304902,501653805811
68,2016-09-20,498636196708,15176233151,448011985,2789447018,46584823,501425643726
69,2016-09-19,497965398653,15970987319,458113075,2886141226,97715212,500851539879
70,2016-09-14,496229314357,15678069181,399261828,2560130168,33751163,498789444525
71,2016-09-13,499635099269,18045851868,426244384,2715487728,30621776,502350586997
72,2016-09-12,499740145178,25293646673,465709861,2893896356,66451677,502634041534
73,2016-09-09,501701136676,21402589584,456713699,2887751901,34540563,504588888577
74,2016-09-08,503708906192,19861671600,464077236,2941733401,31236471,506650639593
75,2016-09-07,503273563343,25787343636,486415126,3021243613,58620249,506294806956
76,2016-09-06,503013816371,24868965139,466174782,2942855884,55852469,505956672255
77,2016-09-05,500516748119,19738718257,470316954,2926669963,58457638,503443418082
78,2016-09-02,499592197550,19720914539,477936580,3055378796,75347741,502647576346
79,2016-09-01,501535695782,20956719333,464663438,3021949312,61126202,504557645094
80,2016-08-31,501716007963,20539638820,445541370,2972281463,54635530,504688289426
81,2016-08-30,501004637549,18127747375,459464394,2942132684,68741513,503946770233
82,2016-08-29,501477435834,19262597443,433383078,2723176228,52040537,504200612062
83,2016-08-26,499937745356,20244740587,413193125,2648511173,34680854,502586256529
84,2016-08-25,500791792381,23464991931,440284911,2748060930,53762538,503539853311
85,2016-08-24,500400801436,20520998519,437582114,2753149425,47004479,503153950861
86,2016-08-23,499734417220,23174573771,442672350,2793503662,57331203,502527920882
87,2016-08-22,499145177131,27494751512,428532762,2738433455,43399057,501883610586
88,2016-08-19,498282428488,28438491033,420104549,2677317602,73765265,500959746090
89,2016-08-18,498543748648,35091631592,403174145,2638732511,41562691,501182481159
90,2016-08-17,495659051254,32177481153,411112441,2685725798,40993272,498344777052
91,2016-08-16,493566088751,41889657998,425996915,2754629970,63014807,496320718721
92,2016-08-15,486485232335,45599596654,456701529,2883440312,92273965,489368672647
93,2016-08-12,479839424564,22006966793,465115409,2705740435,56541175,482545164999
94,2016-08-11,480775762109,22024349627,487745002,2772890637,50664908,483548652746
95,2016-08-10,480718943503,22612841898,482661441,2736885063,53461075,483455828566
96,2016-08-09,479047204988,22848524757,460717073,2643024561,54921971,481690229549
97,2016-08-08,477819998514,21430172220,462116396,2615946503,50381630,480435945017
98,2016-08-05,476692801710,18678111692,441467482,2474642813,40057237,479167444523
99,2016-08-04,477637950967,18769312405,445576381,2512008832,44262829,480149959799
100,2016-08-03,476932091555,18468077204,434926411,2460715830,51204670,479392807385
101,2016-08-02,476393053057,14878698033,411015899,2350121715,28426603,478743174772
102,2016-08-01,476355670754,18019034247,418461422,2352431485,40136631,478708102239
103,2016-07-29,478048309022,19644960366,412096456,2373197134,24671710,480421506156
104,2016-07-28,480421749174,26674128603,430378718,2485031794,51024068,482906780968
105,2016-07-27,482124688799,38181156047,438321183,2502229053,76538726,484626917852
106,2016-07-26,487693941995,23503719129,422853429,2449075034,50838836,490143017029
107,2016-07-25,486965174977,21623531740,402557515,2265389528,28996966,489230564505
108,2016-07-22,485774399944,24165846980,396108001,2273696518,35511469,488048096462
109,2016-07-21,487493320212,25317838648,418468884,2446552497,44999084,489939872709
110,2016-07-20,486271452106,21205037443,408812651,2339523643,27612751,488610975749
111,2016-07-19,485650291962,23944297057,411786317,2313343445,44047567,487963635407
112,2016-07-18,483284066990,26067867176,411505500,2326851515,45236181,485610918505
113,2016-07-15,481144294514,25326907353,392322171,2244011673,30810932,483388306187
114,2016-07-14,482059531983,27102641122,418557552,2366026078,43634449,484425558061
115,2016-07-13,481908335239,36678423531,423099353,2356322937,48346342,484264658176
116,2016-07-12,482110757617,36821977122,476516057,2549096995,66672703,484659854612
117,2016-07-11,479342990976,32614662316,479247541,2469632807,55737335,481812623783
118,2016-07-08,478082382396,23389548398,471563001,2349687842,22199670,480432070238
119,2016-07-07,480968164323,31988828163,508156060,2487269285,45517665,483455433608
120,2016-07-06,480194633761,29106028080,491520521,2419211393,43624495,482613845154
121,2016-07-05,478894481453,32734362701,478227617,2446240005,48180877,481340721458
122,2016-07-04,477343099023,32130856359,460635630,2302250937,62146625,479645349960
123,2016-07-01,473366707712,19675919674,434497231,2099563495,35646834,475466271207
124,2016-06-30,474937137098,21467742218,442419821,2101251811,26303758,477038388909
125,2016-06-29,475231804471,26788675844,447815442,2118405363,64276454,477350209834
126,2016-06-28,473172010473,25173695721,414451274,2001696516,40340399,475173706989
127,2016-06-27,472130992856,23847929426,439742629,1969519019,51126452,474100511875
128,2016-06-24,469568272060,24668541492,430224808,1888549208,54843576,471456821268
129,2016-06-23,470989946736,19023254037,431763853,1990896299,53017447,472980843035
130,2016-06-22,471757473392,18476704112,402136318,1856200904,33557104,473613674296
131,2016-06-21,471148810549,22369420851,408942965,1907486817,49486834,473056297366
132,2016-06-20,471899642785,18147176614,400271759,1868935709,33731307,473768578494
133,2016-06-17,471145006787,22059853838,392024143,1767669480,35213798,472912676267
134,2016-06-16,472426696313,22911662035,417334456,1842035190,33767428,474268731503
135,2016-06-15,472774017130,25071419447,444026379,2030176669,60139809,474804193799
136,2016-06-14,469814782324,14488643361,455743898,2140904265,65977760,471955686589
137,2016-06-13,470718833261,22065754739,430977947,1764666802,58834669,472483500063
138,2016-06-08,472230941146,19223668206,425791006,2083247021,49710215,474314188167
139,2016-06-07,474785801210,18687817684,423323012,1859507222,34423914,476645308432
140,2016-06-06,474696463629,20389851290,406734589,1807091008,24680932,476503554637
141,2016-06-03,473956396588,24400622414,400124553,1795161021,35727267,475751557609
142,2016-06-02,475857307685,22727591932,400678010,1777461682,26956835,477634769367
143,2016-06-01,473842939459,26853747104,389097930,1733878875,27907000,475576818334
144,2016-05-31,472770517075,29411838246,399469150,1773404013,33599650,474543921088
145,2016-05-30,469474286135,12118100614,433400007,1788434447,50249356,471262720582
146,2016-05-27,470933246425,12946566059,408347779,1693078510,15409047,472626324935
147,2016-05-26,472502816382,14550761697,449693374,1847415057,38126177,474350231439
148,2016-05-25,473248745984,13439435439,447111489,1819093057,33450208,475067839041
149,2016-05-24,474113760053,14061116207,435897186,1798419073,34425332,475912179126
150,2016-05-23,473790185446,15087136624,422091594,1753543484,31403739,475543728930
151,2016-05-20,473967145973,14282633644,416942266,1729756848,36595663,475696902821
152,2016-05-19,474796983383,14160647518,422386820,1744718654,14410300,476541702037
153,2016-05-18,474780510464,14732885027,465470861,1881965580,35905915,476662476044
154,2016-05-17,478828511618,15685066169,467485550,1881070331,23463162,480709581949
155,2016-05-16,479976560380,13682998225,459251370,1865306755,14189483,481841867135
156,2016-05-13,479835870205,12799334852,465843265,1867654477,15437677,481703524682
157,2016-05-12,482195898002,14746480437,487960984,1985512603,33452758,484181410605
158,2016-05-11,484223329354,14605560018,476347184,1908372766,26286230,486131702120
159,2016-05-10,486770066004,11967954223,465327237,1848438009,31123109,488618504013
160,2016-05-09,489787952075,18589026402,454084772,1814654742,33873364,491602606817
161,2016-05-06,493019015948,25206015858,448117885,1821751220,35486769,494840767168
162,2016-05-05,498647195271,18795254421,443338759,1866740178,19508495,500513935449
163,2016-05-04,498378241538,21673655978,459179739,1908585250,25394240,500286826788
164,2016-05-03,498068800143,24446886546,459347061,1916449042,18254554,499985249185
165,2016-04-29,494455780517,12930112151,465309165,1889693904,14545540,496345474421
166,2016-04-28,498679671165,16736075918,483917118,1971968247,28580969,500651639412
167,2016-04-27,499245448785,15286475183,478036407,1959244221,38562964,501204693006
168,2016-04-26,500229477522,14289114810,452548563,1912955038,26178572,502142432560
169,2016-04-25,501105836656,14531444301,452977787,1888084518,28658390,502993921174
170,2016-04-22,501699887412,15483224766,434986489,1837147974,12498910,503537035386
171,2016-04-21,504729309486,23671067589,455710066,1927995631,25810818,506657305117
172,2016-04-20,506019596565,33417664759,459026202,1969683025,48540371,507989279590
173,2016-04-19,512299527727,20853636754,445711924,1895798761,27911578,514195326488
174,2016-04-18,512273796689,23645109654,437920187,1884974375,34238477,514158771064
175,2016-04-15,513959169343,25338240194,424461774,1866486619,18578694,515825655962
176,2016-04-14,515461028742,28430104632,423652179,1863849047,21268263,517324877789
177,2016-04-13,514174217320,42312313729,427622877,1858861764,28609114,516033079084
178,2016-04-12,510211622132,22416237700,442288992,1879843609,20861007,512091465741
179,2016-04-11,512127578457,30698107375,437973551,1870649303,14677265,513998227760
180,2016-04-08,509745451220,22781696856,439807776,1843290164,35715099,511588741384
181,2016-04-07,512796499453,28556687517,430255162,1831830901,22893346,514628330354
182,2016-04-06,513684986113,31676123292,425300564,1833000949,18494058,515517987062
183,2016-04-05,512243331494,37092235507,418589155,1822755249,21010858,514066086743
184,2016-04-01,506119519804,24633167935,425548227,1831175662,28752399,507950695466
185,2016-03-31,510077307223,31153041676,413712825,1794732449,25351060,511872039672
186,2016-03-30,509691637569,27927803064,405685748,1774343291,35280473,511465980860
187,2016-03-29,508525327296,21930279771,396181058,1719011642,47876219,510244338938
188,2016-03-28,509242174833,27189283089,372864875,1684440686,36392082,510926615519
189,2016-03-25,508638683094,22318847529,353769333,1635002895,40192809,510273685989
190,2016-03-24,509172156706,31986208234,352121756,1645545414,31359522,510817702120
191,2016-03-23,509741838074,31494180992,337341767,1636604122,23831931,511378442196
192,2016-03-22,507364047862,37857788437,326074971,1604722826,15475715,508968770688
193,2016-03-21,505682813378,50440582760,344925865,1710875104,33931700,507393688482
194,2016-03-18,494872388714,39428741515,368296267,1711273806,30866936,496583662520
195,2016-03-17,488497078304,26128781409,374694739,1724225667,12120751,490221303971
196,2016-03-16,483482073240,14991423218,438763762,1891260265,31708062,485373333505
197,2016-03-15,490445133204,16199416635,426634136,1861084281,37963414,492306217485
198,2016-03-14,493687362449,23766199588,411291055,1810427012,19494774,495497789461
199,2016-03-11,489799692896,12450405720,420066293,1805079703,16191312,491604772599
200,2016-03-10,492042339533,14785943211,428684047,1836636431,11993988,493878975964
201,2016-03-09,492829696125,17033964898,430283330,1893220284,26064592,494722916409
202,2016-03-08,495750615429,23630997269,414150365,1834114044,19682643,497584729473
203,2016-03-07,497412906564,24748130963,417247123,1835425882,17338244,499248332446
204,2016-03-04,494927660917,27790003531,428495044,1855487471,38390367,496783148388
205,2016-03-03,503092878470,31372321447,418744722,1811602760,27678909,504904481230
206,2016-03-02,502350546037,29767561155,410569729,1779203410,37776502,504129749447
207,2016-03-01,499909493421,18523989704,404307775,1688144824,23312246,501597638245
208,2016-02-29,501041987179,16891230852,405231549,1622773378,23683654,502664760557
209,2016-02-26,509938422697,18373537956,399871995,1639939436,25497960,511578362133
210,2016-02-25,513548523851,28390233205,399914491,1632454971,27139662,515180978822
211,2016-02-24,520489250248,26164786546,395478038,1730924643,16853216,522220174891
212,2016-02-23,519105100581,23392174306,390237467,1689257065,15163588,520794357646
213,2016-02-22,519250340741,27522280606,386373075,1692811572,25534802,520943152313
214,2016-02-19,517832856204,18210153720,371916455,1595130626,10528154,519427986830
215,2016-02-18,519382998740,25395778727,383913855,1646122131,14700841,521029120871
216,2016-02-17,518778341837,24752742440,384911339,1657639909,39836772,520435981746
217,2016-02-16,518215198164,23605306843,353115874,1545662014,29933324,519760860178
218,2016-02-15,515256205943,14930797529,338742330,1420264176,33851000,516676470119
219,2016-02-05,514093133618,11901318369,321846648,1357030571,15155083,515450164189
220,2016-02-04,524337017843,18541568615,338921731,1482084171,17319810,525819102014
221,2016-02-03,526428042632,14409477762,344837635,1491080478,12578548,527919123110
222,2016-02-02,528845887864,17563888365,349593177,1511792608,17212053,530357680472
223,2016-02-01,528384301655,14080422778,353673284,1485180379,17458549,529869482034
224,2016-01-29,533033638244,18426533048,357231158,1535234350,22432638,534568872594
225,2016-01-28,537399576006,14896970875,370276921,1540722949,27725726,538940298955
226,2016-01-27,546309759767,19749649503,371387521,1610207999,21792114,547919967766
227,2016-01-26,558948682056,19547611732,386461946,1587722289,26214474,560536404345
228,2016-01-25,573053955612,16889289523,377897322,1696416297,16201169,574750371909
229,2016-01-22,574703509699,17864511418,377134445,1667792073,16171099,576371301772
230,2016-01-21,577982711229,22361174852,399730250,1757858947,38134401,579740570176
231,2016-01-20,581973101059,25779016479,389257526,1710066593,42551370,583683167652
232,2016-01-19,583401330073,25220485677,388529453,1761695979,39923341,585163026052
233,2016-01-18,584010365373,19081125394,368936025,1642374141,23324293,585652739514
234,2016-01-15,585478803003,20242663855,360131694,1613659931,28249261,587092462934
235,2016-01-14,594163365933,22803175759,352386407,1651483595,18888607,595814849528
236,2016-01-13,600445497232,19525346812,367700213,1671474368,22850084,602116971600
237,2016-01-12,610486743606,21769602015,361694462,1687383077,20604486,612174126683
238,2016-01-11,622258836431,28150988168,378464622,1722772476,30254704,623981608907
239,2016-01-08,640940954450,32514181166,366022477,1797468141,20464535,642738422591
240,2016-01-07,653619923734,8743686393,389379514,1865346141,4980100,655485269875
241,2016-01-06,659659894611,31039624222,397866642,2025469549,28591279,661685364160
242,2016-01-05,662424991011,32738126135,386320746,1965327469,31410622,664390318480
243,2016-01-04,674250015171,27746141351,378549763,1930428580,14767084,676180443751
