,rzmre,rzye,rqmcl,rqyl,rqye,rzrqye,opDate
0,38277263968,329575457077,290786402,328745900,2217097425,331792554502,2015-01-05
0,37065808766,330337451354,234959735,336234242,2275278509,332612729863,2015-01-06
0,30805638905,333570682580,204113638,342875246,2340163403,335910845983,2015-01-07
0,28316028226,334537113612,209058725,324338597,2248088027,336785201639,2015-01-08
0,29236879032,334096183516,261141219,300986514,2076584482,336172767998,2015-01-09
0,24331316036,336071465357,234181290,286924013,1985929255,338057394612,2015-01-12
0,22634216323,337225655535,246749378,284409172,1968502622,339194158157,2015-01-13
0,23342662784,341201284890,225359998,275175916,1885368528,343086653418,2015-01-14
0,23670699950,343792509454,250484696,286478745,1960122114,345752631568,2015-01-15
0,29221750218,344702543733,231980680,299066189,2021372924,346723916657,2015-01-16
0,31304297213,340806323416,234662006,246894127,1670336448,342476659864,2015-01-19
0,31398009953,340126356514,336107596,259622924,1781817717,341908174231,2015-01-20
0,38564665690,341025863121,386802664,305343266,2097482947,343123346068,2015-01-21
0,35282495509,344239309794,305167079,324206632,2215205369,346454515163,2015-01-22
0,34841262077,345978090123,248725551,317300913,2122592943,348100683066,2015-01-23
0,31920558738,348777876608,288242119,338834870,2257850624,351035727232,2015-01-26
0,35437544742,350754154067,249811362,318630344,2147278973,352901433040,2015-01-27
0,29225212133,351851747816,244789757,303573505,2053256497,353905004313,2015-01-28
0,24539193611,352732777953,273910756,290243130,1972118240,354704896193,2015-01-29
0,24095669842,351955320963,238686387,276848034,1879167301,353834488264,2015-01-30
0,21344037815,352561010716,213413158,252855955,1756294688,354317305404,2015-02-02
0,25631316321,352958981329,256240585,276127733,1900281199,354859262528,2015-02-03
0,28895466563,354705059515,277211245,274178384,1881711629,356586771144,2015-02-04
0,35743098208,357390541396,306153041,272193497,1831424701,359221966097,2015-02-05
0,26222898191,358519133183,276209853,239049040,1601486889,360120620072,2015-02-06
0,23153875152,361064738115,374575849,230612824,1563247989,362627986104,2015-02-09
0,23874968775,366237990662,333712665,230048820,1583915766,367821906428,2015-02-10
0,26694491460,368845039520,269864795,229244488,1610231794,370455271314,2015-02-11
0,26286269049,368826323472,222629340,227482806,1605529923,370431853395,2015-02-12
0,31880587339,360003378069,282465937,229505421,1643148312,361646526381,2015-02-13
0,35912607418,359694721711,269441277,242116004,1725771717,361420493428,2015-02-16
0,31013959715,352316072724,172001322,231361782,1679482887,353995555611,2015-02-17
0,37884632567,364632460913,215292471,246703315,1778216882,366410677795,2015-02-25
0,34216148792,368651595358,250854806,264214864,1892189423,370543784781,2015-02-26
0,37019956379,371532933772,237175728,263062701,1909555786,373442489558,2015-02-27
0,50204155827,379682012989,364993497,277649739,2043880922,381725893911,2015-03-02
0,51158018793,387698010985,321906050,262309664,1945233104,389643244089,2015-03-03
0,42690922863,393446997427,339268584,278736213,2026477899,395473475326,2015-03-04
0,44225720686,399795847200,341343600,264907608,1966640873,401762488073,2015-03-05
0,38284855895,402334159659,351725197,249381236,1855284739,404189444398,2015-03-06
0,35150008533,406795907407,399289922,241173474,1800104570,408596011977,2015-03-09
0,41198368628,413963887171,429948612,226608594,1729680246,415693567417,2015-03-10
0,39828994953,422017577470,399421741,215420060,1607738035,423625315505,2015-03-11
0,42983488621,430130407909,359215537,221427662,1636224538,431766632447,2015-03-12
0,37807633718,431586133514,317434825,225945311,1672140493,433258274007,2015-03-13
0,51817200508,430037375813,438957290,268341650,1971019595,432008395408,2015-03-16
0,61492982750,432620976886,443646862,273539023,2081796516,434702773402,2015-03-17
0,61433866336,439079318940,443850638,290072802,2229156054,441308474994,2015-03-18
0,58208444120,445156834921,307707743,281311862,2185054379,447341889300,2015-03-19
0,62900138777,449976925205,393858548,304350559,2301310757,452278235962,2015-03-20
0,66646329157,456468114455,392789862,321474072,2461658730,458929773185,2015-03-23
0,79907649786,465149520648,390946343,312335439,2424227164,467573747812,2015-03-24
0,72150523501,475561580264,370579663,314743397,2453452221,478015032485,2015-03-25
0,64379996644,480092915137,396144870,324099949,2457863759,482550778896,2015-03-26
0,49474009451,484087216047,342580626,334795365,2558214628,486645430675,2015-03-27
0,61710664790,489166892146,373054952,356576053,2729213200,491896105346,2015-03-30
0,68420906330,493765560657,393155982,338886850,2628145327,496393705984,2015-03-31
0,66032640455,502453651639,443562681,364316957,2857234816,505310886455,2015-04-01
0,71263078124,509988379711,420837622,368945154,2870700924,512859080635,2015-04-02
0,72768292844,516676930961,372632372,381957722,2977171835,519654102796,2015-04-03
0,76411247986,527220275303,426168950,397736318,3121859985,530342135288,2015-04-07
0,80029308212,534127452357,445994387,387788700,3034345778,537161798135,2015-04-08
0,76120386757,542269865845,476544087,365528545,2852037480,545121903325,2015-04-09
0,65937150651,549425865491,450801200,373732017,2973504472,552399369963,2015-04-10
0,72802345092,559273638521,468240947,363008446,2932318981,562205957502,2015-04-13
0,69349225871,566988822226,491757530,344502232,2808226817,569797049043,2015-04-14
0,65204872955,575375934708,432041797,335933076,2616345990,577992280698,2015-04-15
0,54538805711,580313399643,429185996,341914406,2724163171,583037562814,2015-04-16
0,70769195200,575980304237,504722331,356680372,2843849931,578824154168,2015-04-17
0,78017172912,573835282051,498586432,348021544,2742050269,576577332320,2015-04-20
0,68385035141,576547480301,538328897,360746047,2950727296,579498207597,2015-04-21
0,79322143124,579014805811,486271237,373347999,3138872016,582153677827,2015-04-22
0,81592776204,583954018000,473751321,371342955,3123824480,587077842480,2015-04-23
0,76169130205,588116857679,427961969,369574380,3052072824,591168930503,2015-04-24
0,75863303973,595346164786,495880929,382235136,3196091290,598542256076,2015-04-27
0,74649207663,597896481649,409616365,361059164,3005907060,600902388709,2015-04-28
0,65407486554,604040735304,496015480,371173804,3087185923,607127921227,2015-04-29
0,65134586611,606682432092,390758142,368361389,3017240033,609699672125,2015-04-30
0,59481464470,615989564964,401255695,373377992,3040818126,619030383090,2015-05-04
0,64816633651,624593202195,465593669,316980824,2539901865,627133104060,2015-05-05
0,60906907976,631054246062,512732447,303481684,2413249355,633467495417,2015-05-06
0,46405705807,634109844230,433799512,267809433,2172420457,636282264687,2015-05-07
0,53164484221,629920926522,404161650,266275976,2265422560,632186349082,2015-05-08
0,75294385738,634800787585,542479694,325349942,2749431056,637550218641,2015-05-11
0,78369189860,638556990053,428842507,340728490,2903865717,641460855770,2015-05-12
0,83154757885,648641272851,469034794,348322631,2961858800,651603131651,2015-05-13
0,74221882394,654928816141,471997042,350005857,2937569269,657866385410,2015-05-14
0,66405945997,658559612843,458063793,325594909,2730009491,661289622334,2015-05-15
0,66046414496,668894577990,468306251,303155507,2603193058,671497771048,2015-05-18
0,76581610335,682634693915,513034847,296261753,2617286166,685251980081,2015-05-19
0,90847217448,695732198743,451102502,294236211,2619081393,698351280136,2015-05-20
0,82136863647,703603611405,403821871,323529709,2900452188,706504063593,2015-05-21
0,95129790587,699421477055,462979173,345150261,3080219511,702501696566,2015-05-22
0,94863240548,704770029656,430278166,367034340,3369069699,708139099355,2015-05-25
0,103458479356,713150293302,444643538,368146680,3465510608,716615803910,2015-05-26
0,96807195279,718318501558,422008369,337639705,3299503547,721618005105,2015-05-27
0,107427530431,722038309273,423946926,301618225,2812599180,724850908453,2015-05-28
0,72983634736,723671219259,422506251,272213719,2613167800,726284387059,2015-05-29
0,76378089561,733007153665,534477739,292858602,2856370736,735863524401,2015-06-01
0,82588173381,742214105246,396920629,287070693,2883108282,745097213528,2015-06-02
0,83282082170,747086620524,434872507,289585694,2857001726,749943622250,2015-06-03
0,85128832280,752290936643,446120077,304033132,2848651024,755139587667,2015-06-04
0,92631968257,748157582936,418672454,316675686,3030093245,751187676181,2015-06-05
0,85041374325,746442467724,434973026,328917405,3165781871,749608249595,2015-06-08
0,72503163533,748477647040,397050637,328628067,3141874234,751619521274,2015-06-09
0,74863122982,754930196763,481006752,330873149,3218285055,758148481818,2015-06-10
0,75806602169,761979456459,427364164,335290268,3278375214,765257831673,2015-06-11
0,78004383693,767122163366,501462578,334681002,3284029428,770406192794,2015-06-12
0,78928671819,771159310316,439921656,320242856,3105634844,774264945160,2015-06-15
0,68704456650,775494763565,399603672,284380952,2672185834,778166949399,2015-06-16
0,57647973869,779939203269,506215806,270451450,2599119307,782538322576,2015-06-17
0,54302586867,783724333715,439212038,256851829,2396576792,786120910507,2015-06-18
0,52613840026,781785835539,429820050,194995098,1833178936,783619014475,2015-06-19
0,50361201915,777939378393,501204000,188968127,1894166767,779833545160,2015-06-23
0,57601491190,766627175015,594975097,238183139,2256618737,768883793752,2015-06-24
0,57767003145,758593917931,524349383,243871104,2301780220,760895698151,2015-06-25
0,48864721395,738707126516,566505382,184624774,1714239476,740421365992,2015-06-26
0,57998603023,723644734435,754334135,187672115,1629953335,725274687770,2015-06-29
0,57798561189,709162691967,610388236,185076010,1757399394,710920091361,2015-06-30
0,56949534756,701749001117,510240562,185938632,1690486249,703439487366,2015-07-01
0,47321103534,685837823740,540431101,171425545,1466448908,687304272648,2015-07-02
0,44658045429,661771568517,299123140,135396950,1153988037,662925556554,2015-07-03
0,48178914259,619037358022,103342005,136524693,1103564058,620140922080,2015-07-06
0,24913810751,573004327197,52142398,112379032,911259238,573915586435,2015-07-07
0,15906182294,515212343591,56075451,124035462,883521852,516095865443,2015-07-08
0,26398882911,510159216727,50688548,109839040,875775680,511034992407,2015-07-09
0,27011987685,505945776955,69685177,115325727,956330881,506902107836,2015-07-10
0,38243374580,502705215185,52918106,114120392,980534727,503685749912,2015-07-13
0,44837686658,502165088913,47528878,116865969,979455259,503144544172,2015-07-14
0,48998586370,499370428784,70695331,108574309,900678766,500271107550,2015-07-15
0,43527711140,500271915831,88479426,108598009,903823293,501175739124,2015-07-16
0,50845309187,504255441761,81385359,113256589,976975991,505232417752,2015-07-17
0,57497327280,502482065141,112232060,117320535,992711582,503474776723,2015-07-20
0,49099274153,504055215370,130410016,133435324,1080466093,505135681463,2015-07-21
0,54725753237,507535705730,127384621,140326562,1112220421,508647926151,2015-07-22
0,61035857013,514057673710,167605400,137303845,1131303311,515188977021,2015-07-23
0,66398135946,513599336968,181174800,143431074,1120970976,514720307944,2015-07-24
0,56645261825,507551673784,200074668,141507561,1005867563,508557541347,2015-07-27
0,43301800582,491838698549,201445510,129527120,952151347,492790849896,2015-07-28
0,40350428447,487438624110,180194248,135926756,1019504082,488458128192,2015-07-29
0,44962762796,486249919886,204341485,139970844,1007357911,487257277797,2015-07-30
0,28500813107,475446028932,164324543,139057556,1008473556,476454502488,2015-07-31
0,24653238452,461334491176,88481048,136285888,988706319,462323197495,2015-08-03
0,39427026777,467269519933,5529842,131326368,1025030861,468294550794,2015-08-04
0,38285992283,466810514866,1398208,128981526,987589681,467798104547,2015-08-05
0,26900258682,465555351702,1619600,125981284,957821954,466513173656,2015-08-06
0,36723775989,468603376994,1410500,121109158,951763628,469555140622,2015-08-07
0,52704540514,475981646428,1191900,115487244,951636002,476933282430,2015-08-10
0,55588142308,481040889023,1856400,111523948,925535339,481966424362,2015-08-11
0,42136857991,481886311617,810900,108653651,897773324,482784084941,2015-08-12
0,43735207631,486695514736,1571500,107186090,903864538,487599379274,2015-08-13
0,51053086391,488766646815,1204481,106302528,895942766,489662589581,2015-08-14
0,52161225982,494723065282,35783677,138732262,1078366750,495801432032,2015-08-17
0,58970585163,488823492890,13660962,139440162,1094765773,489918258663,2015-08-18
0,45349832025,486440616365,16109091,141146342,1109871209,487550487574,2015-08-19
0,39502051987,484584219079,31735799,162615934,1163145932,485747365011,2015-08-20
0,32367673587,475023987344,15008228,145246304,1080805032,476104792376,2015-08-21
0,19920856527,449543942965,10473108,141105632,934923484,450478866449,2015-08-24
0,20081701114,419653124847,10213456,136618771,859764730,420512889577,2015-08-25
0,30565114990,401301348852,17367728,143021354,874289506,402175638358,2015-08-26
0,26508724141,389523776632,10187822,142450999,901224016,390425000648,2015-08-27
0,34472692157,389119575750,8946787,142275400,935667614,390055243364,2015-08-28
0,27111521606,382832812309,6951820,143297873,927621583,383760433892,2015-08-31
0,21003546587,369385950822,6315489,143823025,921316059,370307266881,2015-09-01
0,20665732705,352887786561,4936897,141345271,889861777,353777648338,2015-09-02
0,28367062154,359544041278,5730107,138176013,873462157,360417503435,2015-09-07
0,22594119361,359632889283,13914999,135702877,907893807,360540783090,2015-09-08
0,38607572767,364974955542,30765443,155644246,996789544,365971745086,2015-09-09
0,25666974012,364309103755,16686214,147119791,941747016,365250850771,2015-09-10
0,21424035917,362993260509,20292656,148720818,925756756,363919017265,2015-09-11
0,23069430487,353518510882,20300294,150955801,876609403,354395120285,2015-09-14
0,18181415448,345606919457,18472073,152447942,845000006,346451919463,2015-09-15
0,25129563898,347000896835,19328003,154196794,904946243,347905843078,2015-09-16
0,31393490127,347868983179,16092559,152926768,899877756,348768860935,2015-09-17
0,22042698276,347284755690,3041200,141813513,871121963,348155877653,2015-09-18
0,27085902018,348283136964,2113112,140131825,881665269,349164802233,2015-09-21
0,31598565535,348373107279,2121641,136335618,876978020,349250085299,2015-09-22
0,26460495533,348862246310,3861672,139705445,871789392,349734035702,2015-09-23
0,25983071655,349152980691,3220636,141193577,877395639,350030376330,2015-09-24
0,24538918801,345538288563,2727330,142026954,854226871,346392515434,2015-09-25
0,21020312953,347671486613,2064687,140832113,855560394,348527047007,2015-09-28
0,19903012259,344864615171,2139094,140272468,835550189,345700165360,2015-09-29
0,15974888336,338943286646,1462000,132000463,787479419,339730766065,2015-09-30
0,32244629756,346111855937,7714011,138497640,859995782,346971851719,2015-10-08
0,29645835510,347051753251,2450376,136334515,855938047,347907691298,2015-10-09
0,45892092484,354187268018,7790786,137823946,901969466,355089237484,2015-10-12
0,37174398382,357098825623,2629897,135978806,888458456,357987284079,2015-10-13
0,36915211180,359391915344,3712982,136970012,879821283,360271736627,2015-10-14
0,43105120538,365224067914,3646991,137252866,897737421,366121805335,2015-10-15
0,49470121855,367328852147,2414445,131534357,881922699,368210774846,2015-10-16
0,52467987640,373765462867,8562173,138393756,906973353,374672436220,2015-10-19
0,50029978679,378528574870,2988185,135124631,911987824,379440562694,2015-10-20
0,59105720633,375489901292,4435127,136432823,870566320,376360467612,2015-10-21
0,50900527678,383448706603,4855754,138622162,903004763,384351711366,2015-10-22
0,59730354271,388916141368,2163000,136685536,917660635,389833802003,2015-10-23
0,61719662695,395552150573,4012838,137972814,927155450,396479306023,2015-10-26
0,54795514884,399609225675,2618764,136534393,928593701,400537819376,2015-10-27
0,50049288351,399396345382,3188309,137687979,912220060,400308565442,2015-10-28
0,43147285276,403737426794,2214244,136417678,917572978,404654999772,2015-10-29
0,46282631437,403345548720,2557223,135734202,909284203,404254832923,2015-10-30
0,40015560254,403144003168,4039300,137451420,898968381,404042971549,2015-11-02
0,32944090520,404315324117,2233414,135722986,899303465,405214627582,2015-11-03
0,58625456063,413002696228,2106904,131716504,918525655,413921221883,2015-11-04
0,75025127975,418730772360,3923923,131138232,926888761,419657661121,2015-11-05
0,67712813429,423487140458,3427380,131328441,939780185,424426920643,2015-11-06
0,79227993216,435188104397,2628384,130419403,952042853,436140147250,2015-11-09
0,72584549843,442288018676,2232072,130176661,945441429,443233460105,2015-11-10
0,68483121894,451324319084,3360241,131922885,959948566,452284267650,2015-11-11
0,74421219226,459002047278,3109448,131755190,969466075,459971513353,2015-11-12
0,64766100620,460187358032,5551776,132408128,994095983,461181454015,2015-11-13
0,53426266692,467176090609,5695276,132486836,973087581,468149178190,2015-11-16
0,77714136961,475381816828,4990438,133669638,997201843,476379018671,2015-11-17
0,54364966050,477349511755,4866708,134138304,995247801,478344759556,2015-11-18
0,54289681696,485644150604,3485861,132728546,981356613,486625507217,2015-11-19
0,68290597656,491440514083,3061830,131855974,976106964,492416621047,2015-11-20
0,53843881006,490147834279,3140057,121150442,937738648,491085572927,2015-11-23
0,43353366738,492829839713,3110419,121260173,934604725,493764444438,2015-11-24
0,55171032986,496304416380,4316971,123105237,961705079,497266121459,2015-11-25
0,56213525840,495778002956,4130580,124710432,972344450,496750347406,2015-11-26
0,53092359016,486736416738,3952700,121472609,885356944,487621773682,2015-11-27
0,47544815523,487543764636,5083332,119345077,879532864,488423297500,2015-11-30
0,41601546354,487667944960,5362871,120100650,891224862,488559169822,2015-12-01
0,40637352951,485085117143,4989614,120468009,918028139,486003145282,2015-12-02
0,40676585082,483730213419,4330228,121467804,930475040,484660688459,2015-12-03
0,37146465107,474977818244,3421343,121611569,923588888,475901407132,2015-12-04
0,35250842227,474630636414,4045928,123253495,934628088,475565264502,2015-12-07
0,35488239993,472048221063,2226853,122773614,907390333,472955611396,2015-12-08
0,34445027375,472249644756,2638696,122326692,912006867,473161651623,2015-12-09
0,36841180329,471863708372,3443300,122750845,908803148,472772511520,2015-12-10
0,31421945321,472008128192,1711100,119160496,880977348,472889105540,2015-12-11
0,38056397286,478558726084,5207998,121182285,917238211,479475964295,2015-12-14
0,42274898089,481713512936,2314708,118895754,904190935,482617703871,2015-12-15
0,41631227886,484382867758,3757434,118330209,904179374,485287047132,2015-12-16
0,53713649727,485113301374,4419017,120089660,936500857,486049802231,2015-12-17
0,49882785320,486032494977,1627800,117769384,921773140,486954268117,2015-12-18
0,51345983971,490468237765,4498014,119027702,952493906,491420731671,2015-12-21
0,48854384881,495890928603,2575144,115832390,926527770,496817456373,2015-12-22
0,56109064366,500868791669,3085829,114362798,917376486,501786168155,2015-12-23
0,40347912680,504024962717,3549340,107896718,873203631,504898166348,2015-12-24
0,35973896938,504772214499,3167479,98499646,831311445,505603525944,2015-12-25
0,39418250747,495635892706,9551646,104260681,832785094,496468677800,2015-12-28
0,32431827367,497070382702,6192742,102851090,847486717,497917869419,2015-12-29
0,34651073314,497704960328,4676100,103914382,858381242,498563341570,2015-12-30
0,30116089614,490784946519,6672435,107160539,849511267,491634457786,2015-12-31
