opDate,Unnamed: 0,rzmre,rzye,rqmcl,rqyl,rqye,rzrqye
2010-03-31,0,684569,670796,4000,3900,70895,741691
2010-04-01,0,8494307,6871924,0,1300,14707,6886631
2010-04-02,0,6211123,6424142,0,1200,14088,6438230
2010-04-06,0,3832600,4422212,0,1200,13935,4436147
2010-04-07,0,7094565,11515527,0,1100,9476,11525003
2010-04-08,0,6713260,14467758,2100,3100,56023,14523781
2010-04-09,0,9357095,19732998,6700,5400,108362,19841360
2010-04-12,0,10406563,24813027,2200,1000,8100,24821127
2010-04-13,0,10618362,28043418,0,1000,8190,28051608
2010-04-14,0,9419777,31436865,0,1000,8200,31445065
2010-04-15,0,16607172,47980287,4200,5200,97676,48077963
2010-04-16,0,10261947,57295706,0,5200,97186,57392892
2010-04-19,0,16786557,73074834,118600,72900,1388049,74462883
2010-04-20,0,4200533,75880873,0,11000,187320,76068193
2010-04-21,0,6181261,75487129,10000,21000,533090,76020219
2010-04-22,0,24706394,98603964,3200,20300,513260,99117224
2010-04-23,0,16616329,107953879,10100,21000,374180,108328059
2010-04-26,0,8683319,109584858,48700,69700,1362953,110947811
2010-04-27,0,11710150,117633440,18400,84100,1541466,119174906
2010-04-28,0,14705894,130122826,50700,96800,1759408,131882234
2010-04-29,0,8192481,134552434,13000,108800,2147730,136700164
2010-04-30,0,18487739,145916942,5200,39300,824807,146741749
2010-05-04,0,10960784,152252123,36300,63100,1128695,153380818
2010-05-05,0,52075889,198213696,6300,48300,943571,199157267
2010-05-06,0,37006705,216307335,26000,44200,1021638,217328973
2010-05-07,0,13388918,217461595,6409,47409,1084070,218545665
2010-05-10,0,17186304,226993903,9300,50809,1204576,228198479
2010-05-11,0,19447190,238665335,9000,57809,1284209,239949544
2010-05-12,0,10026695,239338755,29100,70109,1637752,240976507
2010-05-13,0,9782955,239722133,7300,61009,1416380,241138513
2010-05-14,0,15697310,245379596,92000,125209,3735181,249114777
2010-05-17,0,21421807,257360668,26700,93019,2605978,259966646
2010-05-18,0,27775902,276904673,169700,237409,5723623,282628296
2010-05-19,0,12619010,285769544,37300,254709,6318489,292088033
2010-05-20,0,27335783,301629547,93700,259709,6543343,308172890
2010-05-21,0,32899042,313678633,98600,248109,6364119,320042752
2010-05-24,0,82092460,374099928,22300,249709,6790778,380890706
2010-05-25,0,40473421,374144433,74078,301431,8343501,382487934
2010-05-26,0,22717703,365206000,0,247909,7314272,372520272
2010-05-27,0,28064935,375593858,6800,175709,5786794,381380652
2010-05-28,0,24686564,384631840,20400,178209,5709141,390340981
2010-05-31,0,33235223,396578128,13900,177509,5563896,402142024
2010-06-01,0,23093598,408895074,42800,177109,5689054,414584128
2010-06-02,0,11264075,413854083,123632,220241,6831122,420685205
2010-06-03,0,39783496,442059040,7700,157209,5296672,447355712
2010-06-04,0,21663003,450040855,110300,226809,6396331,456437186
2010-06-07,0,19287109,446203150,126297,284806,7674888,453878038
2010-06-08,0,16532381,435541649,24800,226206,6876772,442418421
2010-06-09,0,26841829,444326482,157000,302206,8382852,452709334
2010-06-10,0,14716426,446465939,35800,242606,7086189,453552128
2010-06-11,0,21950392,455374946,21000,233506,6816014,462190960
2010-06-17,0,17204323,459532221,24617,254526,7536090,467068311
2010-06-18,0,30673120,475273875,41200,271126,8481917,483755792
2010-06-21,0,30472983,481805448,65400,331326,10267728,492073176
2010-06-22,0,47773802,515889234,55700,331826,10203321,526092555
2010-06-23,0,40757182,542644846,107842,307426,9967572,552612418
2010-06-24,0,32200927,559706984,23260,291486,9875273,569582257
2010-06-25,0,26316812,549025366,7900,247126,8948417,557973783
2010-06-28,0,30394117,566462856,9771,248841,8672207,575135063
2010-06-29,0,32988018,559110157,60638,230507,4719725,563829882
2010-06-30,0,32467445,575139300,76200,276307,6066142,581205442
2010-07-01,0,18590542,540625168,70100,277436,5913644,546538812
2010-07-02,0,31990604,551250750,83258,270094,5289960,556540710
2010-07-05,0,21238391,560774965,112000,310584,6688897,567463862
2010-07-06,0,53507727,597793218,110700,370084,8257426,606050644
2010-07-07,0,52002905,628490733,65800,430664,9322575,637813308
2010-07-08,0,25338054,632780278,88400,446664,9358389,642138667
2010-07-09,0,37711379,628235389,66100,451164,10955067,639190456
2010-07-12,0,79126015,680375732,38600,442564,10707131,691082863
2010-07-13,0,42628630,687671829,20900,461164,10466539,698138368
2010-07-14,0,65154251,718879879,25700,433064,10083845,728963724
2010-07-15,0,44180427,725368184,32011,447547,10401465,735769649
2010-07-16,0,36362263,731981713,55420,470706,11892787,743874500
2010-07-19,0,66729189,732096533,56200,504662,12400631,744497164
2010-07-20,0,105951698,766145268,88800,551202,13540835,779686103
2010-07-21,0,99786083,775220539,19900,554372,13508245,788728784
2010-07-22,0,52190796,792302956,27800,538651,12741845,805044801
2010-07-23,0,79674101,801084471,66000,539301,10638259,811722730
2010-07-26,0,80835582,841666774,136700,638263,11990413,853657187
2010-07-27,0,62568491,860895591,119307,714870,13281410,874177001
2010-07-28,0,82760102,868493098,104500,693670,13771739,882264837
2010-07-29,0,121093140,925481712,42000,691263,13705932,939187644
2010-07-30,0,90619741,953931626,38400,661163,12733309,966664935
2010-08-02,0,88810949,980346775,124054,729317,14638786,994985561
2010-08-03,0,108264964,1028481634,78400,719063,14133704,1042615338
2010-08-04,0,91126485,1067327314,145600,720363,13516874,1080844188
2010-08-05,0,79997431,1087609968,130800,689963,13749185,1101359153
2010-08-06,0,101715360,1087242377,132201,466764,10812491,1098054868
2010-08-09,0,68969732,1077224854,95000,506714,11591817,1088816671
2010-08-10,0,80443213,1060567296,150101,487564,10809214,1071376510
2010-08-11,0,78566562,1095124763,188900,577664,11457249,1106582012
2010-08-12,0,52341941,1042984611,99600,582064,11560396,1054545007
2010-08-13,0,96202684,1064903874,65000,571664,11691225,1076595099
2010-08-16,0,129166740,1119333864,74000,590764,12439894,1131773758
2010-08-17,0,103356483,1127494632,33200,613964,13061043,1140555675
2010-08-18,0,131983515,1160315794,95270,607533,12665874,1172981668
2010-08-19,0,147309664,1211963747,35000,593283,12289484,1224253231
2010-08-20,0,103857732,1218764546,63000,594183,12245953,1231010499
2010-08-23,0,83695708,1243716877,52900,559513,11573432,1255290309
2010-08-24,0,167103101,1330890825,167644,702057,14540950,1345431775
2010-08-25,0,138475638,1366215317,38531,632157,13376760,1379592077
2010-08-26,0,61201318,1353180421,71500,663413,14164612,1367345033
2010-08-27,0,94756571,1392247190,57050,674313,13686792,1405933982
2010-08-30,0,110106373,1387403738,62800,561159,10008173,1397411911
2010-08-31,0,165415024,1452301249,156800,686759,11859490,1464160739
2010-09-01,0,172851806,1518575360,170694,665153,11406001,1529981361
2010-09-02,0,107272647,1507920191,396632,836391,14016268,1521936459
2010-09-03,0,88347611,1473266054,191300,845391,14168481,1487434535
2010-09-06,0,211837410,1512382278,159250,877441,14211494,1526593772
2010-09-07,0,116695957,1484746493,351500,978509,15571405,1500317898
2010-09-08,0,217613284,1597965644,98800,897707,14681417,1612647061
2010-09-09,0,138219203,1610268785,201865,712564,11965439,1622234224
2010-09-10,0,161012447,1666573375,135900,689399,10762388,1677335763
2010-09-13,0,156391239,1718421180,273400,659199,11158764,1729579944
2010-09-14,0,150909722,1743592870,91800,644399,10768260,1754361130
2010-09-15,0,139848262,1735051571,95327,639526,10006600,1745058171
2010-09-16,0,143740535,1764572296,395550,754484,11369846,1775942142
2010-09-17,0,83739790,1762457469,129499,736934,12244709,1774702178
2010-09-20,0,70231299,1754309065,97639,791173,13147264,1767456329
2010-09-21,0,65073023,1720184873,76100,796073,13134737,1733319610
2010-09-27,0,129594656,1792150107,151200,778973,12727122,1804877229
2010-09-28,0,117210614,1804488296,95548,762979,13144279,1817632575
2010-09-29,0,147498153,1817403444,180700,610973,10938878,1828342322
2010-09-30,0,151133350,1839014685,217000,639173,10323765,1849338450
2010-10-08,0,299149555,1895394719,267900,736973,12277758,1907672477
2010-10-11,0,328876466,1875534913,417378,831173,15216027,1890750940
2010-10-12,0,275216020,1917825960,132800,799173,14715513,1932541473
2010-10-13,0,429031853,2035513003,771150,772483,15098604,2050611607
2010-10-14,0,278520630,1968346309,763211,838023,15990810,1984337119
2010-10-15,0,446212106,2069528823,173500,784723,14947916,2084476739
2010-10-18,0,376646997,2018128928,651323,866946,17089663,2035218591
2010-10-19,0,297418477,2097404924,316874,947143,18659406,2116064330
2010-10-20,0,539890233,2239070137,288222,749659,16163700,2255233837
2010-10-21,0,298076113,2241262209,194100,697197,14705690,2255967899
2010-10-22,0,405185999,2276940153,163650,634091,12891798,2289831951
2010-10-25,0,524958000,2430369313,268172,730998,15123851,2445493164
2010-10-26,0,495997419,2451047141,133050,692910,15331403,2466378544
2010-10-27,0,404980742,2487265636,236500,648410,14303368,2501569004
2010-10-28,0,311026827,2571917893,213350,672910,14119478,2586037371
2010-10-29,0,415439364,2654075989,199058,674193,14677678,2668753667
2010-11-01,0,522297409,2852423022,191600,773484,16673448,2869096470
2010-11-02,0,438704086,2717399835,120722,817706,17825161,2735224996
2010-11-03,0,405304373,2756481164,594506,1111112,21788233,2778269397
2010-11-04,0,330101086,2878498243,187000,951280,19249807,2897748050
2010-11-05,0,434990647,2894608821,200900,715305,15889912,2910498733
2010-11-08,0,335339131,2963956875,214546,721009,15481356,2979438231
2010-11-09,0,371147848,3007728218,147500,673184,15673675,3023401893
2010-11-10,0,388294325,3090735094,181281,617165,15765483,3106500577
2010-11-11,0,558386908,3262949185,508742,670908,17169226,3280118411
2010-11-12,0,469668874,3156272675,969062,1120099,22602048,3178874723
2010-11-15,0,332790166,3256258581,273863,585746,11417235,3267675816
2010-11-16,0,260877763,3195412504,223400,635546,11703318,3207115822
2010-11-17,0,278236555,3233920726,266735,586573,11017478,3244938204
2010-11-18,0,181051101,3215318374,469000,605500,11550664,3226869038
2010-11-19,0,249898234,3228894944,618056,546841,10978337,3239873281
2010-11-22,0,300898374,3323417150,550968,786808,16147375,3339564525
2010-11-23,0,211744410,3303100688,630903,779925,16336551,3319437239
2010-11-24,0,342301859,3396294747,466549,619304,13185264,3409480011
2010-11-25,0,317657180,3464085947,619100,781504,16066222,3480152169
2010-11-26,0,274918339,3474069355,482850,733911,16978966,3491048321
2010-11-29,0,272834982,3481725725,353771,570551,12977297,3494703022
2010-11-30,0,299086943,3445087748,553555,704424,15357638,3460445386
2010-12-01,0,178153559,3487747339,300300,710870,14286672,3502034011
2010-12-02,0,263168934,3534257946,263877,705062,15550849,3549808795
2010-12-03,0,190622878,3549247554,300500,646346,12475228,3561722782
2010-12-06,0,220090780,3592140516,319853,693531,14194847,3606335363
2010-12-07,0,234123611,3602427745,353442,697274,15134185,3617561930
2010-12-08,0,261883719,3652918663,390363,767879,16327950,3669246613
2010-12-09,0,228478887,3667683970,256050,539813,13078557,3680762527
2010-12-10,0,259390863,3755177373,220763,555902,12692907,3767870280
2010-12-13,0,377253940,3859239376,363600,466502,10563832,3869803208
2010-12-14,0,278068049,3874636163,259967,547169,11312645,3885948808
2010-12-15,0,366969349,3943707828,382848,621117,15636444,3959344272
2010-12-16,0,269092999,3996222296,160800,433848,10044409,4006266705
2010-12-17,0,241557111,4026985223,144955,395303,8058134,4035043357
2010-12-20,0,309030454,4025804037,186033,456936,9771919,4035575956
2010-12-21,0,308608329,4006630265,394481,567956,11167980,4017798245
2010-12-22,0,372805756,4100889106,429091,458078,11662040,4112551146
2010-12-23,0,301086396,4123750994,359300,592454,12828992,4136579986
2010-12-24,0,221156870,4146748599,512082,576571,12018608,4158767207
2010-12-27,0,337530451,4221194398,617778,640673,15367295,4236561693
2010-12-28,0,243390450,4193878558,166608,517405,9904452,4203783010
2010-12-29,0,227270658,4232964071,162000,451463,8743342,4241707413
2010-12-30,0,253129966,4294876127,366500,406204,8306280,4303182407
2010-12-31,0,289473287,4333096103,191700,346074,6908918,4340005021
2011-01-04,0,348626936,4324595572,466800,592051,10091766,4334687338
2011-01-05,0,437143746,4450633048,438500,499471,8765423,4459398471
2011-01-06,0,263898531,4484305751,337300,586961,11860945,4496166696
2011-01-07,0,361542657,4473830241,548409,802374,14518401,4488348642
2011-01-10,0,229109229,4504336952,324504,713867,12961195,4517298147
2011-01-11,0,223473684,4527434449,352600,691050,12261724,4539696173
2011-01-12,0,243501874,4565020636,615682,961632,17942407,4582963043
2011-01-13,0,200693900,4586248071,183537,817269,15580854,4601828925
2011-01-14,0,254641331,4633414406,510983,1093270,19693839,4653108245
2011-01-17,0,266488258,4624636209,316115,669274,13063845,4637700054
2011-01-18,0,224433705,4695907567,373363,610025,12134877,4708042444
2011-01-19,0,277147941,4739520117,381000,556182,11079645,4750599762
2011-01-20,0,220186952,4729217192,264822,403402,8958437,4738175629
2011-01-21,0,246320905,4721548839,439490,672692,12156972,4733705811
2011-01-24,0,234990695,4691649734,269171,835867,14598320,4706248054
2011-01-25,0,192489609,4735919505,307800,986767,17409683,4753329188
2011-01-26,0,201678761,4803555892,169000,897267,15608388,4819164280
2011-01-27,0,296911893,4762391442,253400,880467,16515462,4778906904
2011-01-28,0,213042065,4766934919,150950,865017,16271668,4783206587
2011-01-31,0,285724750,4798760385,138500,834517,15849586,4814609971
2011-02-01,0,285262796,4829256285,93000,743980,13831264,4843087549
2011-02-09,0,259634876,4888116336,441530,1045010,18908443,4907024779
2011-02-10,0,319780303,4971817942,488292,1178017,22436316,4994254258
2011-02-11,0,342659801,5018051001,406431,1215348,25745969,5043796970
2011-02-14,0,527957101,5043143452,650651,1146441,21019469,5064162921
2011-02-15,0,475034239,5110061400,655138,1283804,24554770,5134616170
2011-02-16,0,508991679,5260632942,472999,1338204,23870188,5284503130
2011-02-17,0,480655518,5259289143,254692,1095496,21059630,5280348773
2011-02-18,0,447588849,5353917725,298187,913682,20402284,5374320009
2011-02-21,0,494657765,5469831272,612730,1242866,26253684,5496084956
2011-02-22,0,499633658,5380701216,1050701,1562955,31483855,5412185071
2011-02-23,0,391832715,5497134482,506026,1163723,25522374,5522656856
2011-02-24,0,386225825,5575581280,597400,1428469,28389717,5603970997
2011-02-25,0,326852084,5545772056,866595,1715269,33832431,5579604487
2011-02-28,0,560826901,5636657087,1262267,2465590,49870599,5686527686
2011-03-01,0,527643532,5712842321,1213395,2481067,51013085,5763855406
2011-03-02,0,486842396,5828162119,1511162,2794260,56862881,5885025000
2011-03-03,0,436460146,5698954101,1516548,3164675,59433169,5758387270
2011-03-04,0,411149197,5830289394,1617266,3368563,62068037,5892357431
2011-03-07,0,801574514,6074952214,914209,3459022,68425912,6143378126
2011-03-08,0,597956595,6192993177,648836,3570739,68234899,6261228076
2011-03-09,0,593520437,6334605332,1225673,4260046,79015800,6413621132
2011-03-10,0,666422633,6492837050,701706,3264162,62476764,6555313814
2011-03-11,0,440305839,6553476099,640767,3002132,55301729,6608777828
2011-03-14,0,454546612,6724942314,761104,3140242,55662694,6780605008
2011-03-15,0,535470371,6742918776,1152184,3004439,57535473,6800454249
2011-03-16,0,521063432,6717346991,1101860,3534888,68822123,6786169114
2011-03-17,0,493367481,6717974713,651841,3334454,64329952,6782304665
2011-03-18,0,431925367,6848719245,712276,3134483,60079089,6908798334
2011-03-21,0,433593845,6835556964,1187014,2976344,59942044,6895499008
2011-03-22,0,488609547,7004303978,663009,2847300,58567710,7062871688
2011-03-23,0,521822799,7061033698,1020154,3100385,62393545,7123427243
2011-03-24,0,450338328,7155158036,651080,3123657,62981910,7218139946
2011-03-25,0,524082063,7154194171,994620,3270374,66344893,7220539064
2011-03-28,0,690558081,7202002895,1462500,3883974,78865549,7280868444
2011-03-29,0,672239486,7241620274,1492811,3499839,68500903,7310121177
2011-03-30,0,567233451,7346190601,1220935,3048883,61047955,7407238556
2011-03-31,0,464982111,7392734666,1264039,3281214,62573333,7455307999
2011-04-01,0,403850864,7438833665,974641,2462979,50316592,7489150257
2011-04-06,0,599364509,7465149400,1948112,3475825,67551698,7532701098
2011-04-07,0,751266787,7648005577,1493490,4181063,81493874,7729499451
2011-04-08,0,593836034,7629891804,691190,3698999,73650756,7703542560
2011-04-11,0,924876433,7828915501,2677932,3680072,62901550,7891817051
2011-04-12,0,690878628,7962021929,2220132,3707469,60480588,8022502517
2011-04-13,0,619696573,8059920454,2161848,4385314,73617228,8133537682
2011-04-14,0,587397540,8130525283,1659511,4868983,77142521,8207667804
2011-04-15,0,632218877,8271149202,2640909,4741940,69163965,8340313167
2011-04-18,0,696521959,8368379870,2466116,4820295,75420306,8443800176
2011-04-19,0,548798822,8328622379,2457487,5101408,75858405,8404480784
2011-04-20,0,575333243,8409289874,1906312,4486147,68989551,8478279425
2011-04-21,0,428139153,8413276304,1796498,4359979,66897347,8480173651
2011-04-22,0,495245356,8433564622,1236007,4002098,60937017,8494501639
2011-04-25,0,561009134,8454549107,1004760,3601477,61543670,8516092777
2011-04-26,0,402452022,8467286433,1131825,3055021,55778842,8523065275
2011-04-27,0,387327616,8453532826,3434810,4594800,78274901,8531807727
2011-04-28,0,476414949,8479605835,2782658,4770224,83201128,8562806963
2011-04-29,0,344581162,8471313494,1855421,4406496,76005914,8547319408
2011-05-03,0,362054676,8447192952,2281534,4919904,81299808,8528492760
2011-05-04,0,421354940,8490462139,2855075,4625013,80459587,8570921726
2011-05-05,0,427234895,8521220807,3435117,5691478,88876972,8610097779
2011-05-06,0,427755835,8530600268,1794310,4536984,81951323,8612551591
2011-05-09,0,323384346,8543860322,2313619,5054401,89247463,8633107785
2011-05-10,0,280411870,8575015677,2250735,4867628,85006937,8660022614
2011-05-11,0,303401230,8574790739,2334705,5486408,95075015,8669865754
2011-05-12,0,339250993,8519358299,2018175,4840037,91294277,8610652576
2011-05-13,0,354025990,8629252915,1802605,4827585,95381978,8724634893
2011-05-16,0,305791589,8701447089,1507598,4872087,92524085,8793971174
2011-05-17,0,450590137,8797164800,2318766,5400072,102342788,8899507588
2011-05-18,0,324735823,8874571321,1497632,5122060,93849614,8968420935
2011-05-19,0,364389752,8949346593,1147943,4840338,91003056,9040349649
2011-05-20,0,295789122,9000190754,2196460,5110390,94838515,9095029269
2011-05-23,0,326234379,8947701185,2037252,4896884,92726334,9040427519
2011-05-24,0,275859568,8988316136,2616565,4938902,89636813,9077952949
2011-05-25,0,276624605,9053323974,1757384,4975397,87880754,9141204728
2011-05-26,0,274469641,9079150796,2139970,4606402,79415261,9158566057
2011-05-27,0,276052255,9060876964,3010867,4672273,83169609,9144046573
2011-05-30,0,238758908,9062148563,1978570,5311841,95335415,9157483978
2011-05-31,0,366249539,9145273821,3710003,5406028,96935563,9242209384
2011-06-01,0,347136422,9186490373,2789468,6104068,104579645,9291070018
2011-06-02,0,429848449,9223848503,2658610,5476273,94753419,9318601922
2011-06-03,0,335082966,9251921673,982737,4898598,90657757,9342579430
2011-06-07,0,271115133,9236171416,2385739,5984537,102758914,9338930330
2011-06-08,0,291752599,9264204948,2130593,5902115,103334199,9367539147
2011-06-09,0,288520669,9292913938,2131547,5932494,101692388,9394606326
2011-06-10,0,369065296,9378764064,2326175,5768670,99474985,9478239049
2011-06-13,0,267614178,9418540791,2267886,5558851,98295934,9516836725
2011-06-14,0,359154844,9378814750,3912324,6113559,106268864,9485083614
2011-06-15,0,457743375,9448018076,2514808,5992601,104299104,9552317180
2011-06-16,0,318542166,9500175541,2348796,5805017,101418589,9601594130
2011-06-17,0,316073891,9508764330,3155895,6466691,112799504,9621563834
2011-06-20,0,387072844,9581600485,2951401,6065616,100738062,9682338547
2011-06-21,0,338159732,9642863703,3218459,6532099,108268827,9751132530
2011-06-22,0,318281186,9648426689,3683899,7227504,117319344,9765746033
2011-06-23,0,443606958,9604643499,2889177,7710298,134809502,9739453001
2011-06-24,0,712274115,9550881596,3681600,8288871,139379918,9690261514
2011-06-27,0,710130808,9681813727,1574402,6825314,125200516,9807014243
2011-06-28,0,602890280,9885880523,2058765,7036873,128396663,10014277186
2011-06-29,0,488677100,9918757231,2457125,7186111,121945620,10040702851
2011-06-30,0,698880606,10008627553,3050501,7569272,134807843,10143435396
2011-07-01,0,814505283,10229910549,4261644,9290744,150496222,10380406771
2011-07-04,0,889706667,10320251059,2563225,9943894,161390215,10481641274
2011-07-05,0,680958022,10503259209,2415244,9647758,155665625,10658924834
2011-07-06,0,871481593,10957137055,2018690,9762090,162699074,11119836129
2011-07-07,0,771672181,11023782815,2110393,9459475,158077627,11181860442
2011-07-08,0,570749568,11034924076,2253205,9773068,165649453,11200573529
2011-07-11,0,538871856,11147082779,2617622,10197896,177397049,11324479828
2011-07-12,0,774510011,11257709888,3270521,8179953,147467902,11405177790
2011-07-13,0,624865462,11403111427,3804598,8765883,159804813,11562916240
2011-07-14,0,725065985,11482859692,2388569,8378219,151179153,11634038845
2011-07-15,0,898543999,11715012145,3863296,8477096,151781964,11866794109
2011-07-18,0,645687753,11847069866,2177084,8210233,160582247,12007652113
2011-07-19,0,633576158,11887352518,2922018,8829181,168507839,12055860357
2011-07-20,0,608793635,11969645857,1344179,8906287,173107385,12142753242
2011-07-21,0,521174200,11918498591,1693529,8060776,169346593,12087845184
2011-07-22,0,479994271,12000906035,1499956,7960196,171609705,12172515740
2011-07-25,0,721456927,12082007843,2124276,7594630,154747661,12236755504
2011-07-26,0,505412900,12198842714,2221696,7641989,153116998,12351959712
2011-07-27,0,526362797,12278036801,2050673,7862996,165178514,12443215315
2011-07-28,0,513636207,12315292855,2547483,7646839,163091692,12478384547
2011-07-29,0,533082220,12346335405,2186269,7483484,151287801,12497623206
2011-08-01,0,486533796,12511992735,1591395,7319415,151045546,12663038281
2011-08-02,0,492176705,12565646294,3946340,8428264,157101288,12722747582
2011-08-03,0,498803840,12667762532,3100124,8269913,161021390,12828783922
2011-08-04,0,314843449,12542989893,2145739,8531178,165733944,12708723837
2011-08-05,0,532262164,12584973661,1955871,7996993,156643024,12741616685
2011-08-08,0,548864625,12506083382,3948161,7919028,152745862,12658829244
2011-08-09,0,640792513,12554353509,4894506,7718177,136723788,12691077297
2011-08-10,0,642473416,12609118948,5188302,8879067,160459798,12769578746
2011-08-11,0,598716149,12646698642,4364855,8813056,157597584,12804296226
2011-08-12,0,522187381,12663181393,2915183,7861570,150533921,12813715314
2011-08-15,0,582106273,12706286309,3722031,8258537,150961675,12857247984
2011-08-16,0,526562981,12800235731,2869557,8998812,165074366,12965310097
2011-08-17,0,372731554,12867051367,2559281,9068428,169203401,13036254768
2011-08-18,0,350141455,12843274512,1998975,8231164,156737946,13000012458
2011-08-19,0,424856622,12813663645,2648014,7753329,153503662,12967167307
2011-08-22,0,407720158,12917933466,2473326,8245382,151980451,13069913917
2011-08-23,0,338786282,13008603198,2517792,8008782,151418967,13160022165
2011-08-24,0,411853026,12992198798,3196962,8877593,172345531,13164544329
2011-08-25,0,641927808,12966151646,4096544,9003541,163043644,13129195290
2011-08-26,0,495795320,12998328619,2381431,9084017,165821400,13164150019
2011-08-29,0,501890644,13115362772,1817620,8379435,163316575,13278679347
2011-08-30,0,473450355,13165406587,2784069,8806929,163336462,13328743049
2011-08-31,0,361553024,13151701562,2018275,7896517,155437380,13307138942
2011-09-01,0,317893118,13085935843,2082890,8247760,162611062,13248546905
2011-09-02,0,342035225,13143378511,3160032,8799773,166965721,13310344232
2011-09-05,0,365670313,13163818271,3733588,9052466,163814511,13327632782
2011-09-06,0,354898288,13193017429,2963572,6891849,138487190,13331504619
2011-09-07,0,444743852,13243431882,3022679,7597138,154045652,13397477534
2011-09-08,0,333326486,13259290654,1601492,6919820,146865912,13406156566
2011-09-09,0,314255268,13165696545,2048116,6742764,141395513,13307092058
2011-09-13,0,308573948,13186217981,2204325,6591234,134280864,13320498845
2011-09-14,0,318252955,13216435369,2431035,6565290,134921624,13351356993
2011-09-15,0,268789514,13116137508,2217985,6846473,138789344,13254926852
2011-09-16,0,263326197,13075681234,3644899,7431371,148982989,13224664223
2011-09-19,0,283491200,13066855821,3251506,8740618,166410388,13233266209
2011-09-20,0,288162571,13091791121,3793110,9031706,161882194,13253673315
2011-09-21,0,597571192,13127630687,4620725,9204908,167168347,13294799034
2011-09-22,0,522373710,13159347001,2834345,8508747,148691116,13308038117
2011-09-23,0,462384456,13130332226,5052897,7284341,135302343,13265634569
2011-09-26,0,327451337,13019087690,3074625,7568388,134679661,13153767351
2011-09-27,0,470337320,13073222366,3671410,7549554,146448379,13219670745
2011-09-28,0,373063081,13001582631,3340209,6141246,129508571,13131091202
2011-09-29,0,313106463,12907471669,3871050,5203792,104475867,13011947536
2011-09-30,0,321934069,12708054431,2858990,4927251,101229323,12809283754
2011-10-10,0,343229734,12749251104,3787135,6026992,117931605,12867182709
2011-10-11,0,624481653,12862806637,7302342,7834144,138437194,13001243831
2011-10-12,0,614621117,12862611420,6806925,9601603,153614927,13016226347
2011-10-13,0,606740009,12928417090,5376413,9550993,151461014,13079878104
2011-10-14,0,411715365,12909298419,4121595,9751272,158895932,13068194351
2011-10-17,0,465068616,12959984618,5124210,10609474,171793062,13131777680
2011-10-18,0,482942560,12950558775,5057280,10241471,172332531,13122891306
2011-10-19,0,382314048,13032991247,5153901,10167863,164765676,13197756923
2011-10-20,0,406782458,13015509880,5417514,9120780,155488351,13170998231
2011-10-21,0,245984683,12967132593,4946618,9293524,154068704,13121201297
2011-10-24,0,486514785,12975957595,6400100,10028093,171409156,13147366751
2011-10-25,0,619624708,12947936169,7025741,10685703,177974430,13125910599
2011-10-26,0,806093013,12995046025,8006484,12882177,199957926,13195003951
2011-10-27,0,539300085,13060104258,5170075,12160499,193069204,13253173462
2011-10-28,0,833614803,12994092888,9673105,13646457,215171710,13209264598
2011-10-31,0,718635762,13165411635,6538972,13586172,210601108,13376012743
2011-11-01,0,712994339,13323204123,6290071,13302128,209583713,13532787836
2011-11-02,0,1002743346,13673114117,7533208,12022823,189695927,13862810044
2011-11-03,0,1218755974,13802913329,7127790,12599045,207340316,14010253645
2011-11-04,0,819509673,13900032653,6149572,12363879,202577494,14102610147
2011-11-07,0,631477864,14027479889,4420826,12333580,202319122,14229799011
2011-11-08,0,535578173,14102856843,5410408,10402089,178523165,14281380008
2011-11-09,0,665575257,14315725927,5198938,10245513,181358681,14497084608
2011-11-10,0,724582831,14402816294,6136879,10099028,175799816,14578616110
2011-11-11,0,521892041,14449154144,6457551,10531682,170119850,14619273994
2011-11-14,0,800085162,14596224492,6902521,12222758,199747357,14795971849
2011-11-15,0,573210169,14737211952,3750449,11384119,193402265,14930614217
2011-11-16,0,665327271,14691379248,5549425,9780932,175937023,14867316271
2011-11-17,0,516586761,14806217702,6486118,11852898,198557299,15004775001
2011-11-18,0,540740278,14798574694,6159747,10541887,172877446,14971452140
2011-11-21,0,376067330,14861368697,5985120,11391775,187302867,15048671564
2011-11-22,0,407395186,14831573441,5666467,11940990,193074863,15024648304
2011-11-23,0,343976459,14759468434,5753028,12519323,203287973,14962756407
2011-11-24,0,459282461,14825588906,6862727,13560769,219023551,15044612457
2011-11-25,0,356190553,14807127239,4683676,13225462,219342926,15026470165
2011-11-28,0,324155537,14715679759,5357705,13269067,223925023,14939604782
2011-11-29,0,437426694,14720215852,5621438,13636283,226615601,14946831453
2011-11-30,0,551745964,14713374663,8065157,14400414,222298313,14935672976
2011-12-01,0,815953384,14746957737,12833795,15166254,226581264,14973539001
2011-12-02,0,447592201,14825143259,8467319,14309399,214162648,15039305907
2011-12-05,0,412684042,14689465254,8867969,14278059,228951168,14918416422
2011-12-06,0,312236233,14607771745,9155649,16484258,252250937,14860022682
2011-12-07,0,322576351,14634557888,7107413,17519971,268670895,14903228783
2011-12-08,0,447917579,14720546052,8480176,17190408,261529284,14982075336
2011-12-09,0,367864761,14720753441,8735983,17210896,256877665,14977631106
2011-12-12,0,282461786,14729285967,7905048,17815382,252525649,14981811616
2011-12-13,0,392465983,14678977610,14158003,18951968,237418723,14916396333
2011-12-14,0,312824023,14635045474,8885003,18958520,234916932,14869962406
2011-12-15,0,420117605,14398566332,12926808,18810774,230623207,14629189539
2011-12-16,0,447390980,14434928167,11227448,18044442,243790459,14678718626
2011-12-19,0,425150177,14532109491,11639558,17879657,233177743,14765287234
2011-12-20,0,403706075,14588450315,11347070,19205216,255342006,14843792321
2011-12-21,0,297578516,14500723775,11552425,20900827,278681477,14779405252
2011-12-22,0,413011802,14517206844,15111191,18994202,267352485,14784559329
2011-12-23,0,396414493,14460648265,14472870,19336862,267079092,14727727357
2011-12-26,0,309985595,14458798084,8728347,19246496,264510661,14723308745
2011-12-27,0,442808018,14508634560,12712904,21322794,270223857,14778858417
2011-12-28,0,349881411,14504892326,17206724,24224774,264812912,14769705238
2011-12-29,0,359938296,14528578304,9262545,22533572,264142257,14792720561
2011-12-30,0,376998445,14384270396,8010217,22057884,277792141,14662062537
2012-01-04,0,450021192,14383321979,12610651,24912118,289131657,14672453636
2012-01-05,0,380923986,14234031728,17378739,28131392,276181136,14510212864
2012-01-06,0,356145055,14182755964,16944488,26329396,265081248,14447837212
2012-01-09,0,546733494,13966086772,15887101,23606771,281265839,14247352611
2012-01-10,0,876894266,13836347686,28081337,32518755,310603034,14146950720
2012-01-11,0,696579821,13849374237,14556425,28427742,288041550,14137415787
2012-01-12,0,580949882,13791890433,10005023,27264440,281191691,14073082124
2012-01-13,0,549596016,13657693471,18877674,27076326,252199479,13909892950
2012-01-16,0,398033894,13600797493,16402762,26285214,264220050,13865017543
2012-01-17,0,752414186,13554355726,22761856,26111964,280336404,13834692130
2012-01-18,0,859299989,13542889550,17861248,26792987,276691495,13819581045
2012-01-19,0,617464979,13267832886,15999894,25259216,268457782,13536290668
2012-01-20,0,601393345,12680614198,17258548,27721030,268326762,12948940960
2012-01-30,0,691077225,12896393162,16236689,30450108,291879028,13188272190
2012-01-31,0,446439752,12966983775,15961103,32027185,297721032,13264704807
2012-02-01,0,484607532,12956172646,15437981,32863219,303309275,13259481921
2012-02-02,0,542130368,13017273902,18375982,33027257,306181091,13323454993
2012-02-03,0,580763555,12880264115,12110701,33473792,314369755,13194633870
2012-02-06,0,678872753,13014081536,12391085,35648454,341148366,13355229902
2012-02-07,0,609679445,13166971324,14182035,32621187,300346284,13467317608
2012-02-08,0,796161463,13108546344,15243530,31505183,317145325,13425691669
2012-02-09,0,775121892,12979377269,18453814,33186209,320932809,13300310078
2012-02-10,0,852981373,13039707139,17139278,33725540,330352393,13370059532
2012-02-13,0,766846785,13179152741,16022269,32625398,332293714,13511446455
2012-02-14,0,590244970,13226235960,12594082,33458730,351615439,13577851399
2012-02-15,0,881886089,13256686475,14386776,35724285,355334235,13612020710
2012-02-16,0,788730093,13343043362,14119532,36125063,351686735,13694730097
2012-02-17,0,660640910,13339129868,10380781,35466072,340204641,13679334509
2012-02-20,0,855308634,13379546997,19228936,42819574,368800957,13748347954
2012-02-21,0,763637743,13364373416,16167895,40487580,361016700,13725390116
2012-02-22,0,1137356794,13277608718,27013105,49206091,417989978,13695598696
2012-02-23,0,1114188935,13230988397,24931709,52637329,427842274,13658830671
2012-02-24,0,1132102648,12957234523,25984038,56338032,448791099,13406025622
2012-02-27,0,1545271934,12991121092,26717485,63218152,484617900,13475738992
2012-02-28,0,1146202717,13191068389,14945985,56996047,432632063,13623700452
2012-02-29,0,1050253827,13338286569,16701420,54671841,416357128,13754643697
2012-03-01,0,916070037,13665131507,14717581,53363398,422937051,14088068558
2012-03-02,0,1085927052,13748171989,26711327,61469372,455684692,14203856681
2012-03-05,0,1186555858,13903628983,19094020,60259359,463072117,14366701100
2012-03-06,0,1076622205,14070539103,18563258,46396158,420217027,14490756130
2012-03-07,0,962283599,14062025201,30901803,58835375,461748993,14523774194
2012-03-08,0,914223805,14154113104,20852009,62777217,484348593,14638461697
2012-03-09,0,1070531030,14203873413,18560118,59009659,487367634,14691241047
2012-03-12,0,1210079072,14463758339,20707157,63764040,472929233,14936687572
2012-03-13,0,1120507973,14651863365,18309938,64155540,493443846,15145307211
2012-03-14,0,1968994046,14728003694,34245957,55365477,430896415,15158900109
2012-03-15,0,1096146687,14797565679,30106635,54483128,440755715,15238321394
2012-03-16,0,959727088,14743837111,25232881,56173589,468744305,15212581416
2012-03-19,0,1076218780,14957800958,19050851,53316996,462388296,15420189254
2012-03-20,0,999317362,15048940749,21705999,53625812,427729868,15476670617
2012-03-21,0,1109416811,15169146280,27012556,52347695,401976446,15571122726
2012-03-22,0,719693933,15226853537,23022559,55642772,421404179,15648257716
2012-03-23,0,741168767,15186178576,16890889,46492230,388380194,15574558770
2012-03-26,0,604376201,15237668408,33159705,50740638,423686586,15661354994
2012-03-27,0,629724377,15212031913,35935814,56134963,410400970,15622432883
2012-03-28,0,865473065,15259609534,25659203,41439133,348091529,15607701063
2012-03-29,0,714200041,15239555959,42908439,42418785,371139801,15610695760
2012-03-30,0,456800389,15038617123,21646172,40553064,358044401,15396661524
2012-04-05,0,760274875,15149580217,64618412,64403203,457861771,15607441988
2012-04-06,0,630154359,15184604492,44560162,81095614,510863257,15695467749
2012-04-09,0,539234655,15136573268,28698489,86336791,515716393,15652289661
2012-04-10,0,652250204,15080301398,40792391,72899029,500926394,15581227792
2012-04-11,0,650406620,15139072889,37410013,75870360,518449411,15657522300
2012-04-12,0,901099561,15053149234,40562042,85595663,552466404,15605615638
2012-04-13,0,1039398494,15048735540,29734908,84954262,543602594,15592338134
2012-04-16,0,814422029,15182829560,21944383,84056713,545313439,15728142999
2012-04-17,0,749810193,15325896277,23132479,78843046,506052294,15831948571
2012-04-18,0,947806970,15323573621,35964004,76634929,532861100,15856434721
2012-04-19,0,879163476,15364446638,25096745,71824761,513725505,15878172143
2012-04-20,0,1005119495,15363184521,20764860,69372018,518040438,15881224959
2012-04-23,0,1086160919,15526699464,22259386,69435031,517528893,16044228357
2012-04-24,0,1114232969,15669279002,37708800,68090950,489058544,16158337546
2012-04-25,0,957849686,15643305399,28438254,76100311,524696322,16168001721
2012-04-26,0,929371123,15506229959,22717368,73561201,508918157,16015148116
2012-04-27,0,775651463,15399406399,33515885,79294556,478913165,15878319564
2012-05-02,0,1402985928,15288552485,26904901,83241533,529841367,15818393852
2012-05-03,0,1076751709,15374172906,18894701,83471399,537652714,15911825620
2012-05-04,0,1002804737,15373030363,22354567,84646373,543054680,15916085043
2012-05-07,0,1163181052,15529439264,24427406,83513497,551847990,16081287254
2012-05-08,0,985505967,15717186052,28990059,79204099,530074209,16247260261
2012-05-09,0,1041473258,15937351440,20170348,72443475,472608061,16409959501
2012-05-10,0,799347850,16009309050,22899245,71429277,476958701,16486267751
2012-05-11,0,836642614,16079168957,34691077,84726574,476558881,16555727838
2012-05-14,0,918285762,16218025756,48113417,98819367,487830085,16705855841
2012-05-15,0,804965691,16237897432,32579740,86260008,477394935,16715292367
2012-05-16,0,729650379,16344963669,20657195,76710347,446671673,16791635342
2012-05-17,0,882470314,16478828847,36785033,92225317,495766574,16974595421
2012-05-18,0,733343954,16416161062,36206029,82536741,472442259,16888603321
2012-05-21,0,798198062,16543774115,28790454,83227505,473711959,17017486074
2012-05-22,0,840914620,16604680902,55065665,102957628,539854252,17144535154
2012-05-23,0,991766083,16732560773,45162947,106390034,573953342,17306514115
2012-05-24,0,1088510124,16978998931,21448464,96515749,541046583,17520045514
2012-05-25,0,773176561,16991575857,33465626,79058457,486319319,17477895176
2012-05-28,0,980019798,16970650181,57672897,89554975,525686211,17496336392
2012-05-29,0,1393834944,16930025456,40252769,85706645,523838448,17453863904
2012-05-30,0,1114405821,17050560321,26068602,88620966,537521835,17588082156
2012-05-31,0,1243432182,17406889226,30957845,74594856,512567829,17919457055
2012-06-01,0,939752536,17395754909,22405341,71907988,490183948,17885938857
2012-06-04,0,1017445731,17495669705,32697160,57181603,454788175,17950457880
2012-06-05,0,779411517,17663975032,35565526,57553536,454746952,18118721984
2012-06-06,0,640129645,17729895124,26058072,60821183,475245122,18205140246
2012-06-07,0,589901652,17651646926,31769164,60785450,471321901,18122968827
2012-06-08,0,684986261,17604057348,28491487,55706463,478136005,18082193353
2012-06-11,0,746684877,17729968883,40628371,69766208,504403779,18234372662
2012-06-12,0,654168340,17740283946,53988184,73404636,508996745,18249280691
2012-06-13,0,874558244,17822191025,36639546,74597230,504887170,18327078195
2012-06-14,0,695389707,17781342352,42550671,81870623,508112776,18289455128
2012-06-15,0,861000960,17865357786,40712711,61723116,460086011,18325443797
2012-06-18,0,828693646,18068119897,27418535,70725184,492499933,18560619830
2012-06-19,0,727314390,18133498376,17662059,63866256,478976605,18612474981
2012-06-20,0,615584189,18168924195,14960710,64251428,472477569,18641401764
2012-06-21,0,749927084,18246649449,31481982,59688650,431919723,18678569172
2012-06-25,0,766445429,18370990168,24838685,50143506,415835298,18786825466
2012-06-26,0,653381537,18441315073,26355130,46926641,437160848,18878475921
2012-06-27,0,599932312,18499659555,55680726,68797424,475484291,18975143846
2012-06-28,0,603026464,18498084910,24326510,55156728,468773306,18966858216
2012-06-29,0,667861641,18485683824,38897909,49396803,447056114,18932739938
2012-07-02,0,904831015,18651902666,25044017,52930238,490184713,19142087379
2012-07-03,0,854947537,18777738229,50715558,64739839,522113719,19299851948
2012-07-04,0,758112504,18800585826,28256302,62086261,514959487,19315545313
2012-07-05,0,767490341,18808020262,34723585,65142938,503423416,19311443678
2012-07-06,0,1129370228,18839059484,54761852,75087656,527770580,19366830064
2012-07-09,0,1061748347,18860924852,31850868,67622847,556949700,19417874552
2012-07-10,0,770826885,18964125689,47765484,65457291,556999263,19521124952
2012-07-11,0,814644216,19019530763,59898064,72255219,574627689,19594158452
2012-07-12,0,1296116056,19081662715,81521268,100157222,594795236,19676457951
2012-07-13,0,979333106,19139246471,36767975,102904058,620295576,19759542047
2012-07-16,0,1054013558,19219929226,33090664,87202128,588593689,19808522915
2012-07-17,0,856149329,19317075167,48120900,72462844,584460638,19901535805
2012-07-18,0,1006873437,19483586632,54828184,66686151,550400326,20033986958
2012-07-19,0,1022316924,19261723330,53028976,66516272,547593512,19809316842
2012-07-20,0,806313576,19328455802,39112282,57200755,507092245,19835548047
2012-07-23,0,730098373,19428958361,32192541,63013255,512600290,19941558651
2012-07-24,0,722057739,19465925042,48509766,75003360,539747670,20005672712
2012-07-25,0,582311609,19412188975,32642064,65444304,538865448,19951054423
2012-07-26,0,744206301,19520965876,55097398,69741032,532005708,20052971584
2012-07-27,0,639589267,19385183944,30867279,68412549,521730619,19906914563
2012-07-30,0,625475887,19377838914,28213999,64779847,538223898,19916062812
2012-07-31,0,595086664,19375025396,28202020,61764208,548138318,19923163714
2012-08-01,0,671441910,19414905899,42148176,66853222,593537938,20008443837
2012-08-02,0,691992395,19508350604,53434341,80586372,568102687,20076453291
2012-08-03,0,686139108,19531960793,47644062,62815166,542213010,20074173803
2012-08-06,0,904311791,19552738943,57152483,78488121,571707394,20124446337
2012-08-07,0,877159985,19618251923,44372786,87827443,578323349,20196575272
2012-08-08,0,928868673,19648601569,29550588,89916646,603717012,20252318581
2012-08-09,0,1064909425,19793276273,32810226,86983327,598932519,20392208792
2012-08-10,0,851788796,19794186183,23044757,78847096,597349107,20391535290
2012-08-13,0,959985415,19867834001,33524831,67529715,544908662,20412742663
2012-08-14,0,881241868,19820100658,43745219,65989497,556693320,20376793978
2012-08-15,0,701696890,19732292994,43602008,71692085,582067457,20314360451
2012-08-16,0,640360537,19661716161,22705319,73597802,593205559,20254921720
2012-08-17,0,761965836,19847331802,34700685,61779611,530649313,20377981115
2012-08-20,0,727998258,19975146882,47551035,86304510,579696864,20554843746
2012-08-21,0,915246493,20174940056,60592986,101311315,607962842,20782902898
2012-08-22,0,806187119,20248197831,26943961,81354930,589506088,20837703919
2012-08-23,0,821310119,20342249262,36083333,87909712,570069870,20912319132
2012-08-24,0,761225747,20308505378,27446990,77215840,555836803,20864342181
2012-08-27,0,792523957,20304927585,39610544,72909241,538006337,20842933922
2012-08-28,0,833294884,20414320955,45553052,85103154,574373778,20988694733
2012-08-29,0,699698704,20527362217,44209035,93368347,572462237,21099824454
2012-08-30,0,898088283,20479253471,49350114,84016443,547399412,21026652883
2012-08-31,0,570852171,20537372002,48939346,85693229,538632377,21076004379
2012-09-03,0,887170850,20678417113,52668956,90168251,597591095,21276008208
2012-09-04,0,858696942,20737011764,53727432,98308475,634367765,21371379529
2012-09-05,0,757881949,20849718397,62637340,100297395,655611306,21505329703
2012-09-06,0,670863579,20897226344,34078061,91726787,620564983,21517791327
2012-09-07,0,1915182624,20768519539,107886076,117744261,596076343,21364595882
2012-09-10,0,1813424488,21047503076,50710135,104536190,631584312,21679087388
2012-09-11,0,1290066745,21346906524,54407325,96990049,626830450,21973736974
2012-09-12,0,1427128466,21486855274,46545099,93146089,636596944,22123452218
2012-09-13,0,1056958660,21557664712,32046431,88521052,600555108,22158219820
2012-09-14,0,1462911177,21635208212,43720920,74684258,588646364,22223854576
2012-09-17,0,1285143630,21820484135,40519555,68978138,536507312,22356991447
2012-09-18,0,932011698,21953858217,41593312,67757902,524050920,22477909137
2012-09-19,0,881341854,22037886262,40913231,71253680,554451244,22592337506
2012-09-20,0,1049965820,22148809027,36981412,74364389,522996057,22671805084
2012-09-21,0,883591835,22119917830,31631209,70509885,519581491,22639499321
2012-09-24,0,816901802,22050118240,77620066,95853792,611557842,22661676082
2012-09-25,0,605450289,21948429000,48205931,96423260,613432006,22561861006
2012-09-26,0,681703749,21910822381,47835399,94575878,577955902,22488778283
2012-09-27,0,1057414080,21534960136,69395656,87195187,599088583,22134048719
2012-09-28,0,1104642128,20945688773,84434369,84468842,588615426,21534304199
2012-10-08,0,1148864805,21390248716,41984110,86892843,594926100,21985174816
2012-10-09,0,1422204713,21551885430,58977039,96969799,667084426,22218969856
2012-10-10,0,1336548281,21923273900,59164656,111011331,689840212,22613114112
2012-10-11,0,1107125774,22062377987,48430333,97629602,625049265,22687427252
2012-10-12,0,1052588089,22223730923,66667066,95676487,619548790,22843279713
2012-10-15,0,1067755485,22287664855,47216757,93279265,630908480,22918573335
2012-10-16,0,1036478530,22296591587,82682328,105598284,662649932,22959241519
2012-10-17,0,1026699443,22514991820,57050757,102030323,654557120,23169548940
2012-10-18,0,1402507939,22615875471,114971312,140162597,715234722,23331110193
2012-10-19,0,1176953800,22558806877,39939499,119677920,699495133,23258302010
2012-10-22,0,1306464825,22975080980,45220245,120749020,702655979,23677736959
2012-10-23,0,1234804495,23235639268,44022990,107833164,662092125,23897731393
2012-10-24,0,1005450855,23301079500,54279286,105600020,658107521,23959187021
2012-10-25,0,1094065346,23421158735,45828154,92695338,628917182,24050075917
2012-10-26,0,1069453460,23645265399,38080374,77211412,538205474,24183470873
2012-10-29,0,692432546,23758680013,49021663,84673221,584295773,24342975786
2012-10-30,0,740251002,23798003449,81198269,102196921,637787761,24435791210
2012-10-31,0,766271102,23712799461,58773527,100523077,661307725,24374107186
2012-11-01,0,1187376395,23647058222,70120527,112390932,698524578,24345582800
2012-11-02,0,960514983,23638498881,43604673,111389599,707875874,24346374755
2012-11-05,0,922442095,23761846706,39282359,110817451,708059822,24469906528
2012-11-06,0,985912763,23809814437,63164334,107402689,703981381,24513795818
2012-11-07,0,871470888,23812148229,45441873,100088315,690961395,24503109624
2012-11-08,0,913270615,23774609134,55406138,97440006,698805817,24473414951
2012-11-09,0,603880576,23682805612,42385920,98698637,677219910,24360025522
2012-11-12,0,732885128,23711765120,66126255,121385241,767887034,24479652154
2012-11-13,0,761419361,23766217264,48009472,112981904,721160217,24487377481
2012-11-14,0,646583024,23762084949,57415343,122426386,756273541,24518358490
2012-11-15,0,633840324,23744396923,57517534,114367698,747779751,24492176674
2012-11-16,0,672976889,23775538017,66122217,108061326,711221917,24486759934
2012-11-19,0,755393562,23779121670,62560711,106736215,720600083,24499721753
2012-11-20,0,631160126,23755732992,87806063,116611389,752506120,24508239112
2012-11-21,0,839151320,23798617416,122060926,146589664,793806913,24592424329
2012-11-22,0,643264264,23806831719,55747624,113359780,786324621,24593156340
2012-11-23,0,631886476,23686493084,69372915,127666144,810893675,24497386759
2012-11-26,0,623748004,23786820975,74783447,124457669,794405759,24581226734
2012-11-27,0,725364923,23755817636,78081321,137202624,814696286,24570513922
2012-11-28,0,605743148,23687138294,57316707,126142475,777985876,24465124170
2012-11-29,0,596336736,23527944733,65788995,129874690,827664148,24355608881
2012-11-30,0,677039406,23364648935,90716675,133156613,858009744,24222658679
2012-12-03,0,852241190,23344058168,78935185,141630137,899949820,24244007988
2012-12-04,0,893339086,23378616244,85879989,168776206,928998540,24307614784
2012-12-05,0,1771086445,23455830357,154604000,182549373,886064634,24341894991
2012-12-06,0,1118526795,23567889782,47413657,175325378,901856526,24469746308
2012-12-07,0,1672478796,23568827688,109024689,178168742,897465358,24466293046
2012-12-10,0,1719875060,23600101274,108433277,217624766,965267942,24565369216
2012-12-11,0,1321837389,23752476711,60995797,204746274,959229916,24711706627
2012-12-12,0,1232121790,23931296294,50174214,182960040,952299531,24883595825
2012-12-13,0,1008590606,24005944092,52384669,168176157,957165797,24963109889
2012-12-14,0,2430566420,24050108360,108442785,156279118,953456644,25003565004
2012-12-17,0,2638935158,24369834749,73475701,162868015,953710531,25323545280
2012-12-18,0,2332120095,24675833764,104963387,174265257,944880358,25620714122
2012-12-19,0,1922452822,24999440910,88480573,192086018,972071959,25971512869
2012-12-20,0,1953597682,25323278100,86284992,180836694,986136074,26309414174
2012-12-21,0,2253066530,25745826781,97735317,183481814,964192329,26710019110
2012-12-24,0,1660218562,25999681453,53303401,186697040,992020483,26991701936
2012-12-25,0,3132675272,26580498165,112604632,196252249,1054376838,27634875003
2012-12-26,0,2288364829,26692499416,88477244,185106665,1027689239,27720188655
2012-12-27,0,2397566150,26879832919,85150098,194981490,1013101318,27892934237
2012-12-28,0,2130970730,26836032972,73728568,167862949,1002579777,27838612749
2012-12-31,0,2541533906,26680230260,98232155,209216753,1069609188,27749839448
2013-01-04,0,2943807115,27099297589,81929626,176080921,1086930604,28186228193
2013-01-07,0,2539903097,27745550185,82624203,194091931,1133396965,28878947150
2013-01-08,0,2414766034,28085898570,82432952,202208321,1117171530,29203070100
2013-01-09,0,2491734472,28344299492,70390680,204006121,1131946319,29476245811
2013-01-10,0,2305081301,28466469117,92938075,219970845,1179973516,29646442633
2013-01-11,0,2392543109,28606461243,62623811,193178285,1112017043,29718478286
2013-01-14,0,3670661355,29299692277,100616852,197651915,1226921808,30526614085
2013-01-15,0,4011581877,30059370327,100967998,211087114,1262191407,31321561734
2013-01-16,0,3278057328,30325333599,96709596,202746396,1253036383,31578369982
2013-01-17,0,2328340294,30589799128,90674360,211584929,1241442926,31831242054
2013-01-18,0,2737844468,30701451603,61332943,193809914,1251730786,31953182389
2013-01-21,0,3190219706,31367605153,134021230,230807976,1333955523,32701560676
2013-01-22,0,3616168195,32044790006,95253090,223068062,1247468742,33292258748
2013-01-23,0,2752428558,32564692477,88021312,237586070,1260387722,33825080199
2013-01-24,0,3381990249,32264032321,110808397,206248915,1254386793,33518419114
2013-01-25,0,2229024585,32520436994,69824601,187306410,1204497976,33724934970
2013-01-28,0,3047430486,32787628108,103925078,207854040,1324656531,34112284639
2013-01-29,0,3727235721,33405273288,108195323,230601851,1329123189,34734396477
2013-01-30,0,3362900478,33987774946,101373993,255145151,1362849865,35350624811
2013-01-31,0,4023149868,33861147901,66491042,209062113,1288590084,35149737985
2013-02-01,0,4266299855,34458704717,89767143,197814213,1286954493,35745659210
2013-02-04,0,5300437812,35486998759,106742450,208440762,1255358422,36742357181
2013-02-05,0,3870869781,35669978400,103365455,201614567,1265159582,36935137982
2013-02-06,0,3552711601,36277506099,39068101,190305520,1228519858,37506025957
2013-02-07,0,3524528817,36724236242,73017914,181597962,1196359611,37920595853
2013-02-08,0,3084625395,35842615852,53561966,164641490,1141996954,36984612806
2013-02-18,0,4206927038,37430265697,70839985,172409447,1170011623,38600277320
2013-02-19,0,3911243818,38731960415,50505460,152197890,1077162783,39809123198
2013-02-20,0,3056715070,39212614730,89677260,188728839,1178070212,40390684942
2013-02-21,0,4025187165,40015702530,112663108,170147020,1017267468,41032969998
2013-02-22,0,2530965269,39921271556,63680707,149870198,991039904,40912311460
2013-02-25,0,2491024691,40472993663,63194764,145947831,1026211625,41499205288
2013-02-26,0,3333185567,41031313073,109212145,181635899,1064429763,42095742836
2013-02-27,0,2433128156,41055486069,84720148,161798816,1069210219,42124696288
2013-02-28,0,3683524231,41409004646,116114118,183763986,1170378054,42579382700
2013-03-01,0,3615978323,41983773537,66467042,159765636,1152745723,43136519260
2013-03-04,0,4616944158,42999617145,90723737,157353967,1032729896,44032347041
2013-03-05,0,4008296537,43740354540,108642568,178252061,1137745809,44878100349
2013-03-06,0,4209248385,44294479993,112925125,194038684,1162181262,45456661255
2013-03-07,0,4227020629,43896109113,125281491,202454429,1135701114,45031810227
2013-03-08,0,3030467403,43987071657,85439434,199459539,1109558048,45096629705
2013-03-11,0,2592272117,44483743056,83035920,192778594,1142918313,45626661369
2013-03-12,0,3126156756,43987235440,101063190,184184846,1085815000,45073050440
2013-03-13,0,2643278687,44502600148,90227799,171576521,1040361961,45542962109
2013-03-14,0,2119089954,44599858873,88241624,181656303,1141767187,45741626060
2013-03-15,0,3179538703,44476405909,130993802,186952116,1131751497,45608157406
2013-03-18,0,2805984335,45017252252,96557228,200118841,1159800374,46177052626
2013-03-19,0,2672239472,45330117598,103361704,194247703,1176210190,46506327788
2013-03-20,0,3982072138,45946162746,113706707,201910534,1239029917,47185192663
2013-03-21,0,3833716918,46555406536,99726724,226750610,1285206270,47840612806
2013-03-22,0,3127675127,47066351328,73952471,219872493,1298942930,48365294258
2013-03-25,0,3102468308,47504286239,95808028,210690549,1288227642,48792513881
2013-03-26,0,3274850839,47943233550,119324480,216178698,1254913338,49198146888
2013-03-27,0,2761019727,48285784980,127406218,208773612,1294005597,49579790577
2013-03-28,0,3178851019,48249521154,69210910,164896276,1145977979,49395499133
2013-03-29,0,2317516935,47940593815,71672506,166027781,1141288542,49081882357
2013-04-01,0,2549563576,48455799112,113083440,181817270,1219155029,49674954141
2013-04-02,0,2893724704,48587759994,144551933,189924916,1205314969,49793074963
2013-04-03,0,2081935539,48448102938,78160614,159658220,1144491567,49592594505
2013-04-08,0,2678869677,49049372615,112672471,170353706,1162830656,50212203271
2013-04-09,0,2747792566,49500549353,161171807,209647154,1222677382,50723226735
2013-04-10,0,2796629589,49691281626,82314776,206258224,1224987619,50916269245
2013-04-11,0,2363993729,50093384318,109306539,215656939,1264233569,51357617887
2013-04-12,0,2194364099,50086057987,77579679,184486267,1213018092,51299076079
2013-04-15,0,2250355517,50267391275,104295552,213005216,1246041959,51513433234
2013-04-16,0,2567004572,50403688364,136696600,247931121,1299879514,51703567878
2013-04-17,0,2556890088,50811009240,99337968,268360499,1371833961,52182843201
2013-04-18,0,2826629357,51169226678,86506085,242615497,1359688788,52528915466
2013-04-19,0,4275496148,51605303306,141592440,229058580,1344339967,52949643273
2013-04-22,0,4339863701,52666787012,85805613,235937883,1375571251,54042358263
2013-04-23,0,3896137052,53097767654,75862856,199844215,1262109265,54359876919
2013-04-24,0,4256215709,53643293901,185370116,222435271,1341190340,54984484241
2013-04-25,0,4431495448,53893980104,166100881,229387216,1283340944,55177321048
2013-04-26,0,3070428514,53130446388,82362509,175301579,1146717598,54277163986
2013-05-02,0,2851416789,53389265264,110999550,205410351,1281790854,54671056118
2013-05-03,0,3678892938,53412882231,152191322,250916074,1332630353,54745512584
2013-05-06,0,4721668474,54669924142,135733302,269438394,1433575746,56103499888
2013-05-07,0,4249555293,55314950990,131170609,281379583,1442836460,56757787450
2013-05-08,0,4210050672,55675878774,117028157,284430189,1515731712,57191610486
2013-05-09,0,4981430668,56532740985,107809008,280742416,1491061069,58023802054
2013-05-10,0,4100969857,56933999592,82484676,240965976,1431503799,58365503391
2013-05-13,0,4094792276,57914030265,137540708,285589726,1431454536,59345484801
2013-05-14,0,4278949948,58875417244,137862141,267285811,1299029404,60174446648
2013-05-15,0,4368942236,59826534526,161686497,286138810,1361790467,61188324993
2013-05-16,0,6054154823,60453928626,268406807,349116127,1463779593,61917708219
2013-05-17,0,5726475059,60796704759,114333789,280983085,1448435134,62245139893
2013-05-20,0,7493277717,62141046767,155431832,303640697,1516687425,63657734192
2013-05-21,0,7411299262,63971390449,102231897,276007834,1509584017,65480974466
2013-05-22,0,6995778696,65200461623,101939598,286321683,1508123158,66708584781
2013-05-23,0,6643936304,66224406982,129090416,279433023,1439953219,67664360201
2013-05-24,0,5510801569,67054886924,103026544,263193803,1401752165,68456639089
2013-05-27,0,6207705498,68437854961,97330395,297965077,1418339798,69856194759
2013-05-28,0,6818119587,69049309636,105370872,279126364,1460372988,70509682624
2013-05-29,0,7161614249,70370409467,94109185,281781328,1467904045,71838313512
2013-05-30,0,6353240686,71556019104,90993668,290423172,1478556615,73034575719
2013-05-31,0,6130445442,72376838981,73142217,246863020,1323916628,73700755609
2013-06-03,0,5555096756,73244396149,79802674,253763909,1312002808,74556398957
2013-06-04,0,5501673090,73889441598,92530668,217013883,1170622000,75060063598
2013-06-05,0,4354012438,74488904230,94037272,230937592,1252619214,75741523444
2013-06-06,0,5080247477,75219166610,83574889,212696267,1197170599,76416337209
2013-06-07,0,4733146584,74727235244,128420480,160805950,1014465820,75741701064
2013-06-13,0,4489090641,75224717534,85082118,145646322,946405676,76171123210
2013-06-14,0,4220547530,75266932669,104802736,173927736,1051707502,76318640171
2013-06-17,0,4755073115,76097436847,98356525,178606888,1124668898,77222105745
2013-06-18,0,3772367069,76422188017,114754829,203170595,1173103139,77595291156
2013-06-19,0,4449728824,77013695404,154088336,226298209,1177369586,78191064990
2013-06-20,0,4246842313,77397729945,114674713,188173545,1106620919,78504350864
2013-06-21,0,3600230737,76954514402,138139645,168021302,1067064779,78021579181
2013-06-24,0,4587140948,76135845373,191861532,160279569,881044353,77016889726
2013-06-25,0,4658048451,74054366166,228772880,125037038,770517304,74824883470
2013-06-26,0,4135139740,74072705966,228158031,194300208,999007083,75071713049
2013-06-27,0,4288572195,73512525211,216722484,226967126,1084569781,74597094992
2013-06-28,0,3566309551,72875058243,229719454,233826373,1149491940,74024550183
2013-07-01,0,3656439253,72751919898,146595794,251401656,1246559798,73998479696
2013-07-02,0,4452601886,72799056177,155386960,284238671,1349939381,74148995558
2013-07-03,0,4784675386,73267992520,171234534,326502250,1397118496,74665111016
2013-07-04,0,5251189063,73382092140,254813112,386114488,1459779623,74841871763
2013-07-05,0,4596839742,73301652889,170792217,384464435,1483659959,74785312848
2013-07-08,0,3866438798,73224164454,178635557,402088138,1440569849,74664734303
2013-07-09,0,2833684865,73135199281,139173647,377314694,1436169914,74571369195
2013-07-10,0,4563044030,73593183390,162391309,393010167,1515685702,75108869092
2013-07-11,0,7349036134,73662053179,204696342,348988453,1464737737,75126790916
2013-07-12,0,6409287578,74011506249,158199322,317001508,1364774566,75376280815
2013-07-15,0,6196478897,74813727905,169492427,323686585,1432047183,76245775088
2013-07-16,0,6123310643,75877436771,154862525,341665036,1467780341,77345217112
2013-07-17,0,5684212876,76315496262,163707120,329077698,1425375420,77740871682
2013-07-18,0,4946523212,77106853255,125389578,317983958,1355527911,78462381166
2013-07-19,0,5646887328,76890872377,179554374,322695215,1300428296,78191300673
2013-07-22,0,4509479798,77802842313,153424401,356494672,1367007577,79169849890
2013-07-23,0,6214358365,78233750263,176723586,348926680,1414041081,79647791344
2013-07-24,0,6735710689,79141374574,123252803,343270262,1381973778,80523348352
2013-07-25,0,6102129203,79217763077,169512283,352109354,1436569916,80654332993
2013-07-26,0,4353128328,79040342685,135696755,349824102,1387136276,80427478961
2013-07-29,0,4483940057,79412718503,126727463,358319182,1398057397,80810775900
2013-07-30,0,4277402125,79290326705,175925109,374229350,1436572612,80726899317
2013-07-31,0,3966250717,78993648353,129021094,389883711,1482704141,80476352494
2013-08-01,0,5756509612,79382002916,143449453,386451204,1461406004,80843408920
2013-08-02,0,5257125227,79181634222,104562701,341770044,1436900311,80618534533
2013-08-05,0,5014914495,79889333313,130775992,364225812,1521573205,81410906518
2013-08-06,0,6229687781,80430657888,154798109,388937207,1529813189,81960471077
2013-08-07,0,6357799870,80421320602,121002149,384711116,1548419286,81969739888
2013-08-08,0,5051367849,81039747913,115405055,390396066,1555416075,82595163988
2013-08-09,0,5347679998,81111415284,97974185,370311086,1523859327,82635274611
2013-08-12,0,7004127474,81341617792,160684919,397798572,1610097236,82951715028
2013-08-13,0,5950329784,82050442160,83195954,381074177,1573622790,83624064950
2013-08-14,0,6220681012,82513441277,129769908,401214785,1598811194,84112252471
2013-08-15,0,5137131117,82812920164,86524865,371022176,1504242307,84317162471
2013-08-16,0,7190031770,82709091315,184142480,340384603,1351525214,84060616529
2013-08-19,0,5249432078,82998984799,140207894,314047417,1398939767,84397924566
2013-08-20,0,5118372392,83215031103,126767255,316262538,1396468180,84611499283
2013-08-21,0,4360328707,83553324470,108687096,310051360,1389431681,84942756151
2013-08-22,0,4691531150,83725300129,95087934,314990164,1413962983,85139263112
2013-08-23,0,6021585674,83613937617,123901139,298190468,1342984270,84956921887
2013-08-26,0,6382021457,84418698866,141898132,337706481,1412791606,85831490472
2013-08-27,0,5504166144,85146039268,81530194,323208355,1388692299,86534731567
2013-08-28,0,6695706809,85670693846,159195780,345077729,1393574527,87064268373
2013-08-29,0,5043307456,86175390968,114613871,333779634,1351862841,87527253809
2013-08-30,0,6335514912,85748691723,133603823,332864369,1327609529,87076301252
2013-09-02,0,5636492032,86257440089,136768501,346694861,1385404796,87642844885
2013-09-03,0,5841468478,86469002886,153159759,362607392,1433999217,87903002103
2013-09-04,0,5736522359,86572248531,93894710,366959016,1443069619,88015318150
2013-09-05,0,5961922117,87173576347,69353711,359579833,1419857061,88593433408
2013-09-06,0,5353744416,87169602831,71246562,342099742,1401277366,88570880197
2013-09-09,0,8651548662,87939517311,151408225,358143563,1446703613,89386220924
2013-09-10,0,8910777764,88811924639,144474017,324078154,1412100506,90224025145
2013-09-11,0,9692985610,89211017795,162441589,319912884,1396509143,90607526938
2013-09-12,0,7694054824,89996527295,137086035,320462695,1389296638,91385823933
2013-09-13,0,6414581289,90102560997,88081596,288251344,1364529532,91467090529
2013-09-16,0,7590805047,91428333120,120523018,316856906,1353959596,92782292716
2013-09-17,0,7293416848,92343420925,96666985,247740961,1261998070,93605418995
2013-09-18,0,5543515702,92127370440,84742868,243478160,1217383990,93344754430
2013-09-23,0,7700224910,93600017357,151542039,289261270,1339334910,94939352267
2013-09-24,0,8936307687,95080067354,113603011,292673658,1301561241,96381628595
2013-09-25,0,8727706165,96197535045,143817653,307700178,1308311477,97505846522
2013-09-26,0,7739204952,96757466358,108446548,247367042,1182616016,97940082374
2013-09-27,0,6206896658,96485701932,81533506,216200267,1149107486,97634809418
2013-09-30,0,5975859610,95705401400,48128218,196304717,1100641339,96806042739
2013-10-08,0,9324783934,97834223068,167218099,266638826,1273132866,99107355934
2013-10-09,0,8301627959,99389769342,79575201,255296348,1253461484,100643230826
2013-10-10,0,9472849061,100838277209,143668424,268236208,1282002450,102120279659
2013-10-11,0,8963686482,101570392394,116839802,252054223,1278301332,102848693726
2013-10-14,0,9548475267,102832589600,94139363,260797079,1314073001,104146662601
2013-10-15,0,9197636676,103862850768,102879420,248857077,1262677800,105125528568
2013-10-16,0,8508459310,104209428015,117898291,225049789,1218008586,105427436601
2013-10-17,0,7444609181,104094599532,117216431,233328475,1237329969,105331929501
2013-10-18,0,6418431052,104170446735,102376635,234563103,1248659146,105419105881
2013-10-21,0,9125567576,105396348912,148161202,258096966,1323984396,106720333308
2013-10-22,0,10288969057,105722213848,115799983,237539617,1265647278,106987861126
2013-10-23,0,9004429874,105781681744,204174432,295960436,1299034692,107080716436
2013-10-24,0,5873188271,106058139231,114811728,235939751,1233241402,107291380633
2013-10-25,0,6953663790,105784880121,131899312,196617412,1114996559,106899876680
2013-10-28,0,5515968931,105661629431,120735546,205553261,1119217843,106780847274
2013-10-29,0,7825222585,104862238545,181125715,209358401,1147599964,106009838509
2013-10-30,0,6191712619,105136676010,142417485,233161321,1233736484,106370412494
2013-10-31,0,5773320513,105219517428,120619756,235760535,1219917023,106439434451
2013-11-01,0,4522990211,104366022209,100515382,224292052,1211202509,105577224718
2013-11-04,0,4456605044,104563530196,84027753,235762328,1226353723,105789883919
2013-11-05,0,5547967064,104899300930,128073060,244144628,1227642534,106126943464
2013-11-06,0,5984357470,104986678608,145157261,264552617,1201444625,106188123233
2013-11-07,0,4905832429,104960990717,129640305,248648427,1163285268,106124275985
2013-11-08,0,4450267012,104624498906,132012898,243300724,1137302458,105761801364
2013-11-11,0,3961488137,104599091137,148463770,258239783,1209067395,105808158532
2013-11-12,0,4494044827,104374065038,151592694,267807023,1269142049,105643207087
2013-11-13,0,4425751960,103954825531,155297523,292808924,1252529296,105207354827
2013-11-14,0,4959778032,103897276579,138538907,253151004,1251442301,105148718880
2013-11-15,0,7218782563,103917975768,148497382,254078835,1217549751,105135525519
2013-11-18,0,8148170503,104538386226,180698073,278296863,1281782631,105820168857
2013-11-19,0,7275231392,105253593734,116546184,278609301,1290263192,106543856926
2013-11-20,0,6558755962,106087273421,87718378,263706932,1305775433,107393048854
2013-11-21,0,7923859609,106899806663,111196507,259571017,1273739359,108173546022
2013-11-22,0,6396685965,106834887807,90837482,240091674,1255453788,108090341595
2013-11-25,0,6204626754,107552152644,131630200,285213608,1305895103,108858047747
2013-11-26,0,5866491843,108101302559,80657769,231922600,1259305311,109360607870
2013-11-27,0,7892170066,108692060976,119828588,244482925,1259393391,109951454367
2013-11-28,0,8615532717,109075735483,159084165,271358235,1286305870,110362041353
2013-11-29,0,7428000039,109122780731,61050924,212001746,1230136924,110352917655
2013-12-02,0,10142057003,109056728460,180800591,256835328,1228199967,110284928427
2013-12-03,0,6520492020,109290544355,148604847,251116378,1299984342,110590528697
2013-12-04,0,8373810515,109631851835,151914615,282828407,1373522515,111005374350
2013-12-05,0,7213238970,109926434622,85137015,255038512,1316872113,111243306735
2013-12-06,0,6240539856,109948679907,66223473,228933028,1273403764,111222083671
2013-12-09,0,6546339489,110759190047,88466784,243965311,1287738664,112046928711
2013-12-10,0,6647166227,111345274365,130911120,273264590,1297537290,112642811655
2013-12-11,0,6043913331,111492453115,76588396,213571456,1199937534,112692390649
2013-12-12,0,5799900378,111937430556,90897525,227414979,1227162480,113164593036
2013-12-13,0,5220758720,111840127972,78399078,224388225,1172186697,113012314669
2013-12-16,0,6070913915,111963376295,94397223,224581489,1129512305,113092888600
2013-12-17,0,4937862080,112372299375,110812571,258670762,1159358888,113531658263
2013-12-18,0,4359318314,112391488844,90505621,226326003,1144735020,113536223864
2013-12-19,0,4918980901,112642522114,86290837,216120924,1111889346,113754411460
2013-12-20,0,4674084066,112576999415,108998701,217944774,1035595339,113612594754
2013-12-23,0,4321763745,112607483627,87966302,191343688,1024918935,113632402562
2013-12-24,0,4702808267,112901535143,120680093,214472828,1078102137,113979637280
2013-12-25,0,5055376006,113599276616,91063321,205178188,1088008027,114687284643
2013-12-26,0,5753362290,114226332960,130772672,231988384,1086356127,115312689087
2013-12-27,0,5383625087,114248007896,139638577,227390973,1100931431,115348939327
2013-12-30,0,6065625465,115481481588,66144194,190200274,1042044684,116523526272
2013-12-31,0,5575720624,115491348382,144110355,224480452,1115029877,116606378259
2014-01-02,0,6186930404,116098519468,77237844,201621568,1074252669,117172772137
2014-01-03,0,6661531106,115981385912,65587202,192849850,1058100295,117039486207
2014-01-06,0,6108909995,116407848924,89056337,184070370,1063119637,117470968561
2014-01-07,0,5072496788,116999398760,68741545,184880964,1085256420,118084655180
2014-01-08,0,7189370956,117577564832,103822313,204823807,1142752205,118720317037
2014-01-09,0,7671101895,118033548830,155373314,236462384,1143927355,119177476185
2014-01-10,0,5533141953,118283934583,102515325,179389250,1032734206,119316668789
2014-01-13,0,5039179023,118268115191,120611819,191014836,1059510565,119327625756
2014-01-14,0,5685888294,118531153414,114265606,193710325,1092400422,119623553836
2014-01-15,0,5747191790,118769845710,83137199,206820052,1134639027,119904484737
2014-01-16,0,5843328386,119012776963,91952561,195281888,1123940064,120136717027
2014-01-17,0,5664614712,119334437800,82592107,189469787,1017359788,120351797588
2014-01-20,0,5210375287,119787905416,87480843,186088064,986907634,120774813050
2014-01-21,0,6142686877,120137128712,75167940,181607498,985368930,121122497642
2014-01-22,0,8616028369,120500016341,136690373,195336853,1024227238,121524243579
2014-01-23,0,8902240777,121140756328,143343171,257914383,1060126180,122200882508
2014-01-24,0,8995284717,121213812624,128326820,223488692,1029533404,122243346028
2014-01-27,0,9497700275,121879708837,114283082,205938426,975807669,122855516506
2014-01-28,0,7086046341,121958918427,94101741,171338364,946928720,122905847147
2014-01-29,0,7297243101,121453515825,65758301,175027776,913093909,122366609734
2014-01-30,0,6235793741,119293796172,39800609,140610859,826943536,120120739708
2014-02-07,0,8299119920,121492862105,109354274,183612836,968990967,122461853072
2014-02-10,0,12285135501,123683414094,148274537,229034271,1040094430,124723508524
2014-02-11,0,13504503311,126089509278,157467063,262455369,1052163889,127141673167
2014-02-12,0,10830429225,127778649968,90153677,264972114,1080941258,128859591226
2014-02-13,0,12112911009,129043098043,144813706,299689377,1082165251,130125263294
2014-02-14,0,8433086184,129064195108,84583392,267871388,1087396806,130151591914
2014-02-17,0,11733437266,130763434575,140405762,269502316,1130397610,131893832185
2014-02-18,0,11885801473,132564178922,180988848,287577914,1125231062,133689409984
2014-02-19,0,11188319569,133479632626,180395166,310901094,1175471771,134655104397
2014-02-20,0,10870380122,134302624574,181881652,314370790,1147789110,135450413684
2014-02-21,0,7939942137,134211467314,104777528,228240317,1043791123,135255258437
2014-02-24,0,9342781426,135112215913,161490062,202465382,982857528,136095073441
2014-02-25,0,11445235276,134552028367,156194354,179378291,915513985,135467542352
2014-02-26,0,8080390067,134337867051,156064700,178204890,903647007,135241514058
2014-02-27,0,9550317478,133836437720,151805227,193343201,947769242,134784206962
2014-02-28,0,7143021269,133000754390,173240638,211916506,972451074,133973205464
2014-03-03,0,7656299094,133291795071,127438940,235581930,1030030936,134321826007
2014-03-04,0,7909021682,133965321608,156310455,260325405,1027792955,134993114563
2014-03-05,0,7474754048,134516959625,153991321,243279962,1041012803,135557972428
2014-03-06,0,7516807984,134721363189,156518646,231114504,1036205414,135757568603
2014-03-07,0,7248556165,133932830874,122851674,247155371,1063205875,134996036749
2014-03-10,0,7180649471,133288015533,169828007,260996888,1016380843,134304396376
2014-03-11,0,5589980928,132752990778,215491341,255574153,1069149681,133822140459
2014-03-12,0,6716508212,131929800058,224718677,297425292,1124373854,133054173912
2014-03-13,0,5745231872,131694749107,190379982,325942602,1207806318,132902555425
2014-03-14,0,5374764793,131263686372,118797340,322342897,1176438641,132440125013
2014-03-17,0,6249357558,131453468039,113493086,343302192,1235208907,132688676946
2014-03-18,0,7096260882,132072359605,104026377,367049698,1251376072,133323735677
2014-03-19,0,6827086333,132753825164,95654090,312445572,1174282213,133928107377
2014-03-20,0,7219817924,132937562110,169760877,321342324,1164110380,134101672490
2014-03-21,0,8008018711,133114506226,181015824,237677808,971871568,134086377794
2014-03-24,0,7948086882,133546362047,169842637,244396348,1020324375,134566686422
2014-03-25,0,7125330842,134110825920,163354256,264868220,1029099678,135139925598
2014-03-26,0,6158261226,134477255344,84285435,247012821,1039102876,135516358220
2014-03-27,0,6938487874,134592397119,131951514,243787663,1029003305,135621400424
2014-03-28,0,6606989111,133999279906,159297456,234626322,969704793,134968984699
2014-03-31,0,4618715517,133734521787,100407703,228180121,985226831,134719748618
2014-04-01,0,4577911116,133390670334,124636959,262520951,1042988390,134433658724
2014-04-02,0,5766793833,133063941990,158103194,283162775,1112260465,134176202455
2014-04-03,0,5755484640,133266368132,129037928,271821584,1096118712,134362486844
2014-04-04,0,5244207881,132678299281,84568006,266560569,1095067920,133773367201
2014-04-08,0,7172488244,132832828796,163546654,247821763,1119306715,133952135511
2014-04-09,0,7179173806,133258482601,102100265,255836046,1141455100,134399937701
2014-04-10,0,9721965982,134157615960,160691382,271171057,1177767503,135335383463
2014-04-11,0,7682016877,134427843354,114487245,274540102,1190500159,135618343513
2014-04-14,0,6733850992,135011278285,106894758,276567767,1200534770,136211813055
2014-04-15,0,7261566971,135400244985,108258900,266191053,1134328933,136534573918
2014-04-16,0,5624550997,135732364471,139721537,265786417,1144112306,136876476777
2014-04-17,0,5861805002,136136680454,115551331,257334362,1110772034,137247452488
2014-04-18,0,4948413204,135570980904,142758958,253359112,1071888428,136642869332
2014-04-21,0,6377622122,135292011116,131998473,246956681,1045036641,136337047757
2014-04-22,0,6197465066,135486243127,158156189,249861118,1055835797,136542078924
2014-04-23,0,4943074933,135294175728,128211400,261007416,1075230690,136369406418
2014-04-24,0,5136860178,135275532849,180459037,243968970,1066785475,136342318324
2014-04-25,0,5154826661,134406598384,122099699,219918244,1013876499,135420474883
2014-04-28,0,5345715474,133801873694,134167644,199195041,967639455,134769513149
2014-04-29,0,4038666972,133078486817,117434492,204754763,996146109,134074632926
2014-04-30,0,3354883748,131777501297,85448605,200215199,992298412,132769799709
2014-05-05,0,4242917102,132144419353,137345399,212464820,1040644207,133185063560
2014-05-06,0,5209048970,132556981545,135869421,218177732,1065537912,133622519457
2014-05-07,0,4395146429,132324345893,126907243,242777528,1069801213,133394147106
2014-05-08,0,4709314220,132360616064,125619544,244405926,1075643580,133436259644
2014-05-09,0,4360540111,132010438866,137488099,227940628,1054300715,133064739581
2014-05-12,0,6852276820,132405875755,171586979,254496938,1126213064,133532088819
2014-05-13,0,5632371472,132650109536,114169492,255315061,1139520839,133789630375
2014-05-14,0,4261432959,132568689405,117127909,267938710,1157814565,133726503970
2014-05-15,0,4658832444,132375602143,101648479,248092121,1115878535,133491480678
2014-05-16,0,3932660093,131855897962,127070249,262493223,1129708911,132985606873
2014-05-19,0,3910163399,131564116814,87946720,242026592,1077349574,132641466388
2014-05-20,0,4146618248,131225946557,81932309,232777480,1068728335,132294674892
2014-05-21,0,4189820434,131425531346,86253647,222906020,1075045093,132500576439
2014-05-22,0,5267616850,131151919689,116013876,243157651,1102100256,132254019945
2014-05-23,0,4934800746,130608288131,110891481,226860151,1078785628,131687073759
2014-05-26,0,6789314445,130924185168,123558308,252080661,1124346645,132048531813
2014-05-27,0,5545951695,130855393558,112279862,276827408,1146483842,132001877400
2014-05-28,0,7447429512,131188336481,174157350,304326523,1179940990,132368277471
2014-05-29,0,7191625222,131519772934,135087554,247588306,1122651594,132642424528
2014-05-30,0,6496001132,131185022857,109460775,245002978,1108008383,132293031240
2014-06-03,0,6321806884,131331394313,89238519,248136871,1137059983,132468454296
2014-06-04,0,6020879826,131973265674,104263156,248676762,1100665089,133073930763
2014-06-05,0,5877935372,131978587266,91724672,267658697,1134439831,133113027097
2014-06-06,0,6206517925,131997487341,70188691,246089347,1097655164,133095142505
2014-06-09,0,6088547697,132433746205,130652812,255654443,1125568617,133559314822
2014-06-10,0,7245413081,132665627006,148772958,292463510,1197410234,133863037240
2014-06-11,0,7225228382,132749429540,146137557,304388212,1223682335,133973111875
2014-06-12,0,6896910949,133166994651,89134697,293803990,1225110922,134392105573
2014-06-13,0,8201708068,133262832272,128378528,296743952,1222813706,134485645978
2014-06-16,0,8964080087,134393068952,116462706,307018945,1277084362,135670153314
2014-06-17,0,8660445341,136299717016,146807753,294557016,1201539381,137501256397
2014-06-18,0,8205915553,137891876951,192074464,270281534,1150559712,139042436663
2014-06-19,0,8237475729,138334689643,111803012,207878564,1010792411,139345482054
2014-06-20,0,5561681024,138219049841,90966317,201147406,1007739279,139226789120
2014-06-23,0,5997731871,138216533467,155652664,218343859,1062524752,139279058219
2014-06-24,0,6237284859,138153448439,150655892,231755144,1103211566,139256660005
2014-06-25,0,6176755759,138654302742,156205066,225313308,1096243772,139750546514
2014-06-26,0,7726380809,138775464865,115057866,248002252,1101034269,139876499134
2014-06-27,0,8394341466,138582906260,117355698,237339521,1074805098,139657711358
2014-06-30,0,9355325114,139675360518,174366071,263711812,1133248305,140808608823
2014-07-01,0,9543534714,140301846226,110867708,269725600,1119316381,141421162607
2014-07-02,0,9523569906,141214732779,198266807,302698763,1146852290,142361585069
2014-07-03,0,10888132802,142431849206,240041598,307324607,1178304375,143610153581
2014-07-04,0,9990288764,143036468752,144420011,295096574,1149594805,144186063557
2014-07-07,0,10082135244,144732310202,197555620,294835391,1164342730,145896652932
2014-07-08,0,10280355447,146058741454,173199190,298056168,1173817561,147232559015
2014-07-09,0,11256492049,146858751178,133057290,271078134,1115310851,147974062029
2014-07-10,0,9671896576,147918438249,142060185,264198296,1106517378,149024955627
2014-07-11,0,9086575841,148434713823,112566092,245386717,1099447305,149534161128
2014-07-14,0,11352731283,149705817334,193860759,249991034,1100989778,150806807112
2014-07-15,0,11128919228,150398955359,221531826,271010306,1149593656,151548549015
2014-07-16,0,9576239699,151107413961,149483130,268347967,1180895088,152288309049
2014-07-17,0,7511188507,151453736609,124124114,264750312,1147108624,152600845233
2014-07-18,0,7389383370,150656631387,162606318,269313555,1186869113,151843500500
2014-07-21,0,7627013884,151122355870,140226373,283996067,1201726716,152324082586
2014-07-22,0,9607476528,151433243819,246962277,340443406,1279172339,152712416158
2014-07-23,0,10718692223,152861324301,250529581,316453504,1237764367,154099088668
2014-07-24,0,12019984434,153504405640,241870828,312198588,1261619597,154766025237
2014-07-25,0,10490987981,153400798150,202168875,320100247,1303921447,154704719597
2014-07-28,0,14856621970,152256189541,285211467,407027451,1499143179,153755332720
2014-07-29,0,15019480387,152833431488,236272484,442766017,1567598445,154401029933
2014-07-30,0,14150818664,154590068304,215434361,446757769,1591042130,156181110434
2014-07-31,0,13803857773,156553677865,210603987,466995952,1631115901,158184793766
2014-08-01,0,13972960532,156453118772,191597082,453875292,1601948793,158055067565
2014-08-04,0,12928829401,157788137497,211735811,484563400,1706992424,159495129921
2014-08-05,0,15054580464,159016516470,168441321,485149638,1692680249,160709196719
2014-08-06,0,14936898893,160502620399,204993796,465110045,1631808491,162134428890
2014-08-07,0,14176843064,161586436400,175790858,415409175,1520801547,163107237947
2014-08-08,0,11536925743,161773588797,139121493,387694254,1470083027,163243671824
2014-08-11,0,13302118470,162852733564,203306995,422439888,1596942406,164449675970
2014-08-12,0,14514746240,164974841167,144979980,411737476,1551015900,166525857067
2014-08-13,0,15741495340,167461113601,240788437,412186429,1565459972,169026573573
2014-08-14,0,14596155139,169134129287,168002928,407536641,1513634094,170647763381
2014-08-15,0,13672194354,169486106208,226489824,445050627,1572690419,171058796627
2014-08-18,0,16689123260,171787204800,168231021,438900634,1588702350,173375907150
2014-08-19,0,18320059671,172847992920,182014235,452462286,1619974688,174467967608
2014-08-20,0,16411051741,174787344145,181494836,462733489,1633109695,176420453840
2014-08-21,0,16340018547,176790093199,169538019,429681365,1586285318,178376378517
2014-08-22,0,15309048202,177595643285,175002277,421923701,1575603853,179171247138
2014-08-25,0,15622385752,179750871827,182164554,407562414,1529420073,181280291900
2014-08-26,0,15185454933,181687145410,214768868,392328324,1451348148,183138493558
2014-08-27,0,12104512169,183263199094,231029323,383104552,1389626303,184652825397
2014-08-28,0,12610666124,186179508950,231813936,338078850,1291279446,187470788396
2014-08-29,0,9827926694,187066201291,111888671,232062562,1274282107,188340483398
2014-09-01,0,13977770282,189148341022,187673739,238672157,1321860139,190470201161
2014-09-02,0,17264400270,188988952878,165024299,260735699,1433345687,190422298565
2014-09-03,0,18933623110,189182008296,204244224,278562289,1528541918,190710550214
2014-09-04,0,19599953843,191599924958,155221797,284997149,1571388551,193171313509
2014-09-05,0,19640827736,192230401519,180145500,290891800,1592383729,193822785248
2014-09-09,0,19112781349,194952306356,198947757,294226717,1608174042,196560480398
2014-09-10,0,18128204651,197804122291,187249541,288948672,1596092247,199400214538
2014-09-11,0,22874034263,200627702338,208754236,284080530,1581467642,202209169980
2014-09-12,0,16344150919,201790280729,234936228,278809602,1554256128,203344536857
2014-09-15,0,20366110750,205422474650,223888251,280449475,1570580292,206993054942
2014-09-16,0,23540331174,206778495582,226005533,266112722,1476789752,208255285334
2014-09-17,0,15957228262,208199324898,158615872,267718725,1516400393,209715725291
2014-09-18,0,14248555754,209395171107,166779283,279241124,1556774977,210951946084
2014-09-19,0,13817407150,209664826746,106434562,277120723,1538033117,211202859863
2014-09-22,0,17125294379,213381690141,111081677,244843533,1414659491,214796349632
2014-09-23,0,16211241348,216433330722,172176897,264453479,1487059958,217920390680
2014-09-24,0,22662607837,221650790476,201095042,264880850,1473263454,223124053930
2014-09-25,0,24352569715,225681032296,155541367,248161619,1410691750,227091724046
2014-09-26,0,18470982053,227206882365,143645440,246489900,1390607533,228597489898
2014-09-29,0,19185419168,226368010070,134641727,247355333,1411802865,227779812935
2014-09-30,0,16812119186,221183132346,91187362,230314939,1318105923,222501238269
2014-10-08,0,24801851916,228208036824,181038568,275818527,1540895789,229748932613
2014-10-09,0,26982269155,232733934061,160306738,284452743,1588835014,234322769075
2014-10-10,0,23571897590,235240705935,182999272,288162722,1600021913,236840727848
2014-10-13,0,21202583287,238718075412,196221256,277839694,1580212717,240298288129
2014-10-14,0,20909159330,241097505816,194682992,283529755,1619385808,242716891624
2014-10-15,0,21055176792,243708517436,217288843,285107520,1636057649,245344575085
2014-10-16,0,21055221732,244007042999,208607520,293314966,1644464491,245651507490
2014-10-17,0,18757948350,243931556370,178042461,273096401,1555945854,245487502224
2014-10-20,0,15458021594,245220110697,232678904,292967702,1662995442,246883106139
2014-10-21,0,15982971644,246365692928,113356760,271358582,1579397419,247945090347
2014-10-22,0,15329574777,247833277989,159191250,264116781,1489942521,249323220510
2014-10-23,0,16045968146,250370954468,201829828,228363057,1329591072,251700545540
2014-10-24,0,12568279885,251332983613,128737306,208456779,1267486313,252600469926
2014-10-27,0,12885339079,252916459729,183860123,199560607,1248420527,254164880256
2014-10-28,0,16557603324,251306469383,215771487,219134227,1383416639,252689886022
2014-10-29,0,23970392094,251830402363,240339363,245239853,1504530459,253334932822
2014-10-30,0,22137209086,253395341460,228130385,273199527,1606838649,255002180109
2014-10-31,0,22500570555,253259536186,263297877,290873662,1645781655,254905317841
2014-11-03,0,21355091937,255658025353,266343384,306994386,1718135827,257376161180
2014-11-04,0,22491184008,258290310680,215364486,318231708,1756780883,260047091563
2014-11-05,0,20987436212,260594884943,219635509,318264173,1790499789,262385384732
2014-11-06,0,18383625835,261977486810,172237176,309588787,1762640409,263740127219
2014-11-07,0,25019734450,262233726193,252284263,311570794,1757450550,263991176743
2014-11-10,0,22310332417,263599380069,270261491,332709404,1852427880,265451807949
2014-11-11,0,28073319217,264328693624,258814994,317109053,1763847091,266092540715
2014-11-12,0,17142506870,264919682375,237642773,332211216,1859825486,266779507861
2014-11-13,0,22517557164,265676217340,264024902,345717609,1857395270,267533612610
2014-11-14,0,16068029189,266181873622,199022944,323722085,1775241387,267957115009
2014-11-17,0,17043638187,267342627179,225378604,323541778,1812735062,269155362241
2014-11-18,0,14862522482,268351515901,178058197,305743985,1755251272,270106767173
2014-11-19,0,17096805905,269405793692,191242443,310211366,1771528058,271177321750
2014-11-20,0,15319797385,270730793831,140775754,315594325,1775076736,272505870567
2014-11-21,0,19657481810,271672855406,223698056,311658669,1716778801,273389634207
2014-11-24,0,34954091461,278405738436,336917391,309052554,1746093244,280151831680
2014-11-25,0,32469707549,283420919136,267335640,304100740,1761501506,285182420642
2014-11-26,0,33420588560,287575797759,252625282,318937690,1826268166,289402065925
2014-11-27,0,33734596483,288079438888,269690700,334266100,1914063295,289993502183
2014-11-28,0,37849678582,289934216371,299036412,351175932,1987144178,291921360549
2014-12-01,0,35872122585,293170546376,286926186,359653226,2059722118,295230268494
2014-12-02,0,34348297767,294527445532,275500849,354486894,2133764989,296661210521
2014-12-03,0,50318919860,297569545429,309540337,346409206,2111661061,299681206490
2014-12-04,0,51221931387,304103426914,312031713,352794198,2248152394,306351579308
2014-12-05,0,54407472156,305619301293,287757854,328168122,2109259405,307728560698
2014-12-08,0,50853489641,312025936835,366153701,353930718,2293215519,314319152354
2014-12-09,0,60506193793,314472401276,337941775,319951130,1984107319,316456508595
2014-12-10,0,39157124060,314842016854,303101831,317447074,2072611552,316914628406
2014-12-11,0,37899510038,317130122385,232298472,324283089,2127206495,319257328880
2014-12-12,0,32936080725,317342860758,230269902,315045383,2099936678,319442797436
2014-12-15,0,35588227437,320561784841,229232481,314968913,2111951458,322673736299
2014-12-16,0,38453978168,323932822626,343519347,325775821,2198618522,326131441148
2014-12-17,0,43066419642,328402340960,279891170,323405493,2143780566,330546121526
2014-12-18,0,34059840272,330563940557,316837289,315656041,2008214912,332572155469
2014-12-19,0,35368656188,332887991493,340102717,299311484,1872487066,334760478559
2014-12-22,0,36497842145,333117999016,301243510,310883725,1891669889,335009668905
2014-12-23,0,24242924569,330834683231,276853395,294083664,1833442059,332668125290
2014-12-24,0,21361323013,328550084368,223066427,266501594,1683814097,330233898465
2014-12-25,0,21369685576,327672264887,294727242,294317861,1865345672,329537610559
2014-12-26,0,28614849447,327402063637,255053986,316823652,2020274211,329422337848
2014-12-29,0,34808467204,329726505575,238802841,318269814,2019141043,331745646618
2014-12-30,0,27279943983,329254424765,212808474,317070915,2003342173,331257766938
2014-12-31,0,26844068469,327068013659,206231236,318763061,2069543360,329137557019
2015-01-05,0,38277263968,329575457077,290786402,328745900,2217097425,331792554502
2015-01-06,0,37065808766,330337451354,234959735,336234242,2275278509,332612729863
2015-01-07,0,30805638905,333570682580,204113638,342875246,2340163403,335910845983
2015-01-08,0,28316028226,334537113612,209058725,324338597,2248088027,336785201639
2015-01-09,0,29236879032,334096183516,261141219,300986514,2076584482,336172767998
2015-01-12,0,24331316036,336071465357,234181290,286924013,1985929255,338057394612
2015-01-13,0,22634216323,337225655535,246749378,284409172,1968502622,339194158157
2015-01-14,0,23342662784,341201284890,225359998,275175916,1885368528,343086653418
2015-01-15,0,23670699950,343792509454,250484696,286478745,1960122114,345752631568
2015-01-16,0,29221750218,344702543733,231980680,299066189,2021372924,346723916657
2015-01-19,0,31304297213,340806323416,234662006,246894127,1670336448,342476659864
2015-01-20,0,31398009953,340126356514,336107596,259622924,1781817717,341908174231
2015-01-21,0,38564665690,341025863121,386802664,305343266,2097482947,343123346068
2015-01-22,0,35282495509,344239309794,305167079,324206632,2215205369,346454515163
2015-01-23,0,34841262077,345978090123,248725551,317300913,2122592943,348100683066
2015-01-26,0,31920558738,348777876608,288242119,338834870,2257850624,351035727232
2015-01-27,0,35437544742,350754154067,249811362,318630344,2147278973,352901433040
2015-01-28,0,29225212133,351851747816,244789757,303573505,2053256497,353905004313
2015-01-29,0,24539193611,352732777953,273910756,290243130,1972118240,354704896193
2015-01-30,0,24095669842,351955320963,238686387,276848034,1879167301,353834488264
2015-02-02,0,21344037815,352561010716,213413158,252855955,1756294688,354317305404
2015-02-03,0,25631316321,352958981329,256240585,276127733,1900281199,354859262528
2015-02-04,0,28895466563,354705059515,277211245,274178384,1881711629,356586771144
2015-02-05,0,35743098208,357390541396,306153041,272193497,1831424701,359221966097
2015-02-06,0,26222898191,358519133183,276209853,239049040,1601486889,360120620072
2015-02-09,0,23153875152,361064738115,374575849,230612824,1563247989,362627986104
2015-02-10,0,23874968775,366237990662,333712665,230048820,1583915766,367821906428
2015-02-11,0,26694491460,368845039520,269864795,229244488,1610231794,370455271314
2015-02-12,0,26286269049,368826323472,222629340,227482806,1605529923,370431853395
2015-02-13,0,31880587339,360003378069,282465937,229505421,1643148312,361646526381
2015-02-16,0,35912607418,359694721711,269441277,242116004,1725771717,361420493428
2015-02-17,0,31013959715,352316072724,172001322,231361782,1679482887,353995555611
2015-02-25,0,37884632567,364632460913,215292471,246703315,1778216882,366410677795
2015-02-26,0,34216148792,368651595358,250854806,264214864,1892189423,370543784781
2015-02-27,0,37019956379,371532933772,237175728,263062701,1909555786,373442489558
2015-03-02,0,50204155827,379682012989,364993497,277649739,2043880922,381725893911
2015-03-03,0,51158018793,387698010985,321906050,262309664,1945233104,389643244089
2015-03-04,0,42690922863,393446997427,339268584,278736213,2026477899,395473475326
2015-03-05,0,44225720686,399795847200,341343600,264907608,1966640873,401762488073
2015-03-06,0,38284855895,402334159659,351725197,249381236,1855284739,404189444398
2015-03-09,0,35150008533,406795907407,399289922,241173474,1800104570,408596011977
2015-03-10,0,41198368628,413963887171,429948612,226608594,1729680246,415693567417
2015-03-11,0,39828994953,422017577470,399421741,215420060,1607738035,423625315505
2015-03-12,0,42983488621,430130407909,359215537,221427662,1636224538,431766632447
2015-03-13,0,37807633718,431586133514,317434825,225945311,1672140493,433258274007
2015-03-16,0,51817200508,430037375813,438957290,268341650,1971019595,432008395408
2015-03-17,0,61492982750,432620976886,443646862,273539023,2081796516,434702773402
2015-03-18,0,61433866336,439079318940,443850638,290072802,2229156054,441308474994
2015-03-19,0,58208444120,445156834921,307707743,281311862,2185054379,447341889300
2015-03-20,0,62900138777,449976925205,393858548,304350559,2301310757,452278235962
2015-03-23,0,66646329157,456468114455,392789862,321474072,2461658730,458929773185
2015-03-24,0,79907649786,465149520648,390946343,312335439,2424227164,467573747812
2015-03-25,0,72150523501,475561580264,370579663,314743397,2453452221,478015032485
2015-03-26,0,64379996644,480092915137,396144870,324099949,2457863759,482550778896
2015-03-27,0,49474009451,484087216047,342580626,334795365,2558214628,486645430675
2015-03-30,0,61710664790,489166892146,373054952,356576053,2729213200,491896105346
2015-03-31,0,68420906330,493765560657,393155982,338886850,2628145327,496393705984
2015-04-01,0,66032640455,502453651639,443562681,364316957,2857234816,505310886455
2015-04-02,0,71263078124,509988379711,420837622,368945154,2870700924,512859080635
2015-04-03,0,72768292844,516676930961,372632372,381957722,2977171835,519654102796
2015-04-07,0,76411247986,527220275303,426168950,397736318,3121859985,530342135288
2015-04-08,0,80029308212,534127452357,445994387,387788700,3034345778,537161798135
2015-04-09,0,76120386757,542269865845,476544087,365528545,2852037480,545121903325
2015-04-10,0,65937150651,549425865491,450801200,373732017,2973504472,552399369963
2015-04-13,0,72802345092,559273638521,468240947,363008446,2932318981,562205957502
2015-04-14,0,69349225871,566988822226,491757530,344502232,2808226817,569797049043
2015-04-15,0,65204872955,575375934708,432041797,335933076,2616345990,577992280698
2015-04-16,0,54538805711,580313399643,429185996,341914406,2724163171,583037562814
2015-04-17,0,70769195200,575980304237,504722331,356680372,2843849931,578824154168
2015-04-20,0,78017172912,573835282051,498586432,348021544,2742050269,576577332320
2015-04-21,0,68385035141,576547480301,538328897,360746047,2950727296,579498207597
2015-04-22,0,79322143124,579014805811,486271237,373347999,3138872016,582153677827
2015-04-23,0,81592776204,583954018000,473751321,371342955,3123824480,587077842480
2015-04-24,0,76169130205,588116857679,427961969,369574380,3052072824,591168930503
2015-04-27,0,75863303973,595346164786,495880929,382235136,3196091290,598542256076
2015-04-28,0,74649207663,597896481649,409616365,361059164,3005907060,600902388709
2015-04-29,0,65407486554,604040735304,496015480,371173804,3087185923,607127921227
2015-04-30,0,65134586611,606682432092,390758142,368361389,3017240033,609699672125
2015-05-04,0,59481464470,615989564964,401255695,373377992,3040818126,619030383090
2015-05-05,0,64816633651,624593202195,465593669,316980824,2539901865,627133104060
2015-05-06,0,60906907976,631054246062,512732447,303481684,2413249355,633467495417
2015-05-07,0,46405705807,634109844230,433799512,267809433,2172420457,636282264687
2015-05-08,0,53164484221,629920926522,404161650,266275976,2265422560,632186349082
2015-05-11,0,75294385738,634800787585,542479694,325349942,2749431056,637550218641
2015-05-12,0,78369189860,638556990053,428842507,340728490,2903865717,641460855770
2015-05-13,0,83154757885,648641272851,469034794,348322631,2961858800,651603131651
2015-05-14,0,74221882394,654928816141,471997042,350005857,2937569269,657866385410
2015-05-15,0,66405945997,658559612843,458063793,325594909,2730009491,661289622334
2015-05-18,0,66046414496,668894577990,468306251,303155507,2603193058,671497771048
2015-05-19,0,76581610335,682634693915,513034847,296261753,2617286166,685251980081
2015-05-20,0,90847217448,695732198743,451102502,294236211,2619081393,698351280136
2015-05-21,0,82136863647,703603611405,403821871,323529709,2900452188,706504063593
2015-05-22,0,95129790587,699421477055,462979173,345150261,3080219511,702501696566
2015-05-25,0,94863240548,704770029656,430278166,367034340,3369069699,708139099355
2015-05-26,0,103458479356,713150293302,444643538,368146680,3465510608,716615803910
2015-05-27,0,96807195279,718318501558,422008369,337639705,3299503547,721618005105
2015-05-28,0,107427530431,722038309273,423946926,301618225,2812599180,724850908453
2015-05-29,0,72983634736,723671219259,422506251,272213719,2613167800,726284387059
2015-06-01,0,76378089561,733007153665,534477739,292858602,2856370736,735863524401
2015-06-02,0,82588173381,742214105246,396920629,287070693,2883108282,745097213528
2015-06-03,0,83282082170,747086620524,434872507,289585694,2857001726,749943622250
2015-06-04,0,85128832280,752290936643,446120077,304033132,2848651024,755139587667
2015-06-05,0,92631968257,748157582936,418672454,316675686,3030093245,751187676181
2015-06-08,0,85041374325,746442467724,434973026,328917405,3165781871,749608249595
2015-06-09,0,72503163533,748477647040,397050637,328628067,3141874234,751619521274
2015-06-10,0,74863122982,754930196763,481006752,330873149,3218285055,758148481818
2015-06-11,0,75806602169,761979456459,427364164,335290268,3278375214,765257831673
2015-06-12,0,78004383693,767122163366,501462578,334681002,3284029428,770406192794
2015-06-15,0,78928671819,771159310316,439921656,320242856,3105634844,774264945160
2015-06-16,0,68704456650,775494763565,399603672,284380952,2672185834,778166949399
2015-06-17,0,57647973869,779939203269,506215806,270451450,2599119307,782538322576
2015-06-18,0,54302586867,783724333715,439212038,256851829,2396576792,786120910507
2015-06-19,0,52613840026,781785835539,429820050,194995098,1833178936,783619014475
2015-06-23,0,50361201915,777939378393,501204000,188968127,1894166767,779833545160
2015-06-24,0,57601491190,766627175015,594975097,238183139,2256618737,768883793752
2015-06-25,0,57767003145,758593917931,524349383,243871104,2301780220,760895698151
2015-06-26,0,48864721395,738707126516,566505382,184624774,1714239476,740421365992
2015-06-29,0,57998603023,723644734435,754334135,187672115,1629953335,725274687770
2015-06-30,0,57798561189,709162691967,610388236,185076010,1757399394,710920091361
2015-07-01,0,56949534756,701749001117,510240562,185938632,1690486249,703439487366
2015-07-02,0,47321103534,685837823740,540431101,171425545,1466448908,687304272648
2015-07-03,0,44658045429,661771568517,299123140,135396950,1153988037,662925556554
2015-07-06,0,48178914259,619037358022,103342005,136524693,1103564058,620140922080
2015-07-07,0,24913810751,573004327197,52142398,112379032,911259238,573915586435
2015-07-08,0,15906182294,515212343591,56075451,124035462,883521852,516095865443
2015-07-09,0,26398882911,510159216727,50688548,109839040,875775680,511034992407
2015-07-10,0,27011987685,505945776955,69685177,115325727,956330881,506902107836
2015-07-13,0,38243374580,502705215185,52918106,114120392,980534727,503685749912
2015-07-14,0,44837686658,502165088913,47528878,116865969,979455259,503144544172
2015-07-15,0,48998586370,499370428784,70695331,108574309,900678766,500271107550
2015-07-16,0,43527711140,500271915831,88479426,108598009,903823293,501175739124
2015-07-17,0,50845309187,504255441761,81385359,113256589,976975991,505232417752
2015-07-20,0,57497327280,502482065141,112232060,117320535,992711582,503474776723
2015-07-21,0,49099274153,504055215370,130410016,133435324,1080466093,505135681463
2015-07-22,0,54725753237,507535705730,127384621,140326562,1112220421,508647926151
2015-07-23,0,61035857013,514057673710,167605400,137303845,1131303311,515188977021
2015-07-24,0,66398135946,513599336968,181174800,143431074,1120970976,514720307944
2015-07-27,0,56645261825,507551673784,200074668,141507561,1005867563,508557541347
2015-07-28,0,43301800582,491838698549,201445510,129527120,952151347,492790849896
2015-07-29,0,40350428447,487438624110,180194248,135926756,1019504082,488458128192
2015-07-30,0,44962762796,486249919886,204341485,139970844,1007357911,487257277797
2015-07-31,0,28500813107,475446028932,164324543,139057556,1008473556,476454502488
2015-08-03,0,24653238452,461334491176,88481048,136285888,988706319,462323197495
2015-08-04,0,39427026777,467269519933,5529842,131326368,1025030861,468294550794
2015-08-05,0,38285992283,466810514866,1398208,128981526,987589681,467798104547
2015-08-06,0,26900258682,465555351702,1619600,125981284,957821954,466513173656
2015-08-07,0,36723775989,468603376994,1410500,121109158,951763628,469555140622
2015-08-10,0,52704540514,475981646428,1191900,115487244,951636002,476933282430
2015-08-11,0,55588142308,481040889023,1856400,111523948,925535339,481966424362
2015-08-12,0,42136857991,481886311617,810900,108653651,897773324,482784084941
2015-08-13,0,43735207631,486695514736,1571500,107186090,903864538,487599379274
2015-08-14,0,51053086391,488766646815,1204481,106302528,895942766,489662589581
2015-08-17,0,52161225982,494723065282,35783677,138732262,1078366750,495801432032
2015-08-18,0,58970585163,488823492890,13660962,139440162,1094765773,489918258663
2015-08-19,0,45349832025,486440616365,16109091,141146342,1109871209,487550487574
2015-08-20,0,39502051987,484584219079,31735799,162615934,1163145932,485747365011
2015-08-21,0,32367673587,475023987344,15008228,145246304,1080805032,476104792376
2015-08-24,0,19920856527,449543942965,10473108,141105632,934923484,450478866449
2015-08-25,0,20081701114,419653124847,10213456,136618771,859764730,420512889577
2015-08-26,0,30565114990,401301348852,17367728,143021354,874289506,402175638358
2015-08-27,0,26508724141,389523776632,10187822,142450999,901224016,390425000648
2015-08-28,0,34472692157,389119575750,8946787,142275400,935667614,390055243364
2015-08-31,0,27111521606,382832812309,6951820,143297873,927621583,383760433892
2015-09-01,0,21003546587,369385950822,6315489,143823025,921316059,370307266881
2015-09-02,0,20665732705,352887786561,4936897,141345271,889861777,353777648338
2015-09-07,0,28367062154,359544041278,5730107,138176013,873462157,360417503435
2015-09-08,0,22594119361,359632889283,13914999,135702877,907893807,360540783090
2015-09-09,0,38607572767,364974955542,30765443,155644246,996789544,365971745086
2015-09-10,0,25666974012,364309103755,16686214,147119791,941747016,365250850771
2015-09-11,0,21424035917,362993260509,20292656,148720818,925756756,363919017265
2015-09-14,0,23069430487,353518510882,20300294,150955801,876609403,354395120285
2015-09-15,0,18181415448,345606919457,18472073,152447942,845000006,346451919463
2015-09-16,0,25129563898,347000896835,19328003,154196794,904946243,347905843078
2015-09-17,0,31393490127,347868983179,16092559,152926768,899877756,348768860935
2015-09-18,0,22042698276,347284755690,3041200,141813513,871121963,348155877653
2015-09-21,0,27085902018,348283136964,2113112,140131825,881665269,349164802233
2015-09-22,0,31598565535,348373107279,2121641,136335618,876978020,349250085299
2015-09-23,0,26460495533,348862246310,3861672,139705445,871789392,349734035702
2015-09-24,0,25983071655,349152980691,3220636,141193577,877395639,350030376330
2015-09-25,0,24538918801,345538288563,2727330,142026954,854226871,346392515434
2015-09-28,0,21020312953,347671486613,2064687,140832113,855560394,348527047007
2015-09-29,0,19903012259,344864615171,2139094,140272468,835550189,345700165360
2015-09-30,0,15974888336,338943286646,1462000,132000463,787479419,339730766065
2015-10-08,0,32244629756,346111855937,7714011,138497640,859995782,346971851719
2015-10-09,0,29645835510,347051753251,2450376,136334515,855938047,347907691298
2015-10-12,0,45892092484,354187268018,7790786,137823946,901969466,355089237484
2015-10-13,0,37174398382,357098825623,2629897,135978806,888458456,357987284079
2015-10-14,0,36915211180,359391915344,3712982,136970012,879821283,360271736627
2015-10-15,0,43105120538,365224067914,3646991,137252866,897737421,366121805335
2015-10-16,0,49470121855,367328852147,2414445,131534357,881922699,368210774846
2015-10-19,0,52467987640,373765462867,8562173,138393756,906973353,374672436220
2015-10-20,0,50029978679,378528574870,2988185,135124631,911987824,379440562694
2015-10-21,0,59105720633,375489901292,4435127,136432823,870566320,376360467612
2015-10-22,0,50900527678,383448706603,4855754,138622162,903004763,384351711366
2015-10-23,0,59730354271,388916141368,2163000,136685536,917660635,389833802003
2015-10-26,0,61719662695,395552150573,4012838,137972814,927155450,396479306023
2015-10-27,0,54795514884,399609225675,2618764,136534393,928593701,400537819376
2015-10-28,0,50049288351,399396345382,3188309,137687979,912220060,400308565442
2015-10-29,0,43147285276,403737426794,2214244,136417678,917572978,404654999772
2015-10-30,0,46282631437,403345548720,2557223,135734202,909284203,404254832923
2015-11-02,0,40015560254,403144003168,4039300,137451420,898968381,404042971549
2015-11-03,0,32944090520,404315324117,2233414,135722986,899303465,405214627582
2015-11-04,0,58625456063,413002696228,2106904,131716504,918525655,413921221883
2015-11-05,0,75025127975,418730772360,3923923,131138232,926888761,419657661121
2015-11-06,0,67712813429,423487140458,3427380,131328441,939780185,424426920643
2015-11-09,0,79227993216,435188104397,2628384,130419403,952042853,436140147250
2015-11-10,0,72584549843,442288018676,2232072,130176661,945441429,443233460105
2015-11-11,0,68483121894,451324319084,3360241,131922885,959948566,452284267650
2015-11-12,0,74421219226,459002047278,3109448,131755190,969466075,459971513353
2015-11-13,0,64766100620,460187358032,5551776,132408128,994095983,461181454015
2015-11-16,0,53426266692,467176090609,5695276,132486836,973087581,468149178190
2015-11-17,0,77714136961,475381816828,4990438,133669638,997201843,476379018671
2015-11-18,0,54364966050,477349511755,4866708,134138304,995247801,478344759556
2015-11-19,0,54289681696,485644150604,3485861,132728546,981356613,486625507217
2015-11-20,0,68290597656,491440514083,3061830,131855974,976106964,492416621047
2015-11-23,0,53843881006,490147834279,3140057,121150442,937738648,491085572927
2015-11-24,0,43353366738,492829839713,3110419,121260173,934604725,493764444438
2015-11-25,0,55171032986,496304416380,4316971,123105237,961705079,497266121459
2015-11-26,0,56213525840,495778002956,4130580,124710432,972344450,496750347406
2015-11-27,0,53092359016,486736416738,3952700,121472609,885356944,487621773682
2015-11-30,0,47544815523,487543764636,5083332,119345077,879532864,488423297500
2015-12-01,0,41601546354,487667944960,5362871,120100650,891224862,488559169822
2015-12-02,0,40637352951,485085117143,4989614,120468009,918028139,486003145282
2015-12-03,0,40676585082,483730213419,4330228,121467804,930475040,484660688459
2015-12-04,0,37146465107,474977818244,3421343,121611569,923588888,475901407132
2015-12-07,0,35250842227,474630636414,4045928,123253495,934628088,475565264502
2015-12-08,0,35488239993,472048221063,2226853,122773614,907390333,472955611396
2015-12-09,0,34445027375,472249644756,2638696,122326692,912006867,473161651623
2015-12-10,0,36841180329,471863708372,3443300,122750845,908803148,472772511520
2015-12-11,0,31421945321,472008128192,1711100,119160496,880977348,472889105540
2015-12-14,0,38056397286,478558726084,5207998,121182285,917238211,479475964295
2015-12-15,0,42274898089,481713512936,2314708,118895754,904190935,482617703871
2015-12-16,0,41631227886,484382867758,3757434,118330209,904179374,485287047132
2015-12-17,0,53713649727,485113301374,4419017,120089660,936500857,486049802231
2015-12-18,0,49882785320,486032494977,1627800,117769384,921773140,486954268117
2015-12-21,0,51345983971,490468237765,4498014,119027702,952493906,491420731671
2015-12-22,0,48854384881,495890928603,2575144,115832390,926527770,496817456373
2015-12-23,0,56109064366,500868791669,3085829,114362798,917376486,501786168155
2015-12-24,0,40347912680,504024962717,3549340,107896718,873203631,504898166348
2015-12-25,0,35973896938,504772214499,3167479,98499646,831311445,505603525944
2015-12-28,0,39418250747,495635892706,9551646,104260681,832785094,496468677800
2015-12-29,0,32431827367,497070382702,6192742,102851090,847486717,497917869419
2015-12-30,0,34651073314,497704960328,4676100,103914382,858381242,498563341570
2015-12-31,0,30116089614,490784946519,6672435,107160539,849511267,491634457786
2016-01-04,0,27402626573,484575797895,4573160,102836053,772108644,485347906539
2016-01-05,0,33426737789,475037821454,4279198,102368063,757383802,475795205256
2016-01-06,0,29252419826,471911650743,1484979,101159077,760843433,472672494176
2016-01-07,0,7894567602,466443947090,255600,100044022,689704107,467133651197
2016-01-08,0,28983324654,455663747282,2049550,99968306,704908892,456368656174
2016-01-11,0,24058303886,439819813926,2312555,99393255,669283223,440489097149
2016-01-12,0,21556485360,432250707788,1361947,95564657,661841749,432912549537
2016-01-13,0,19636801143,423530065764,1082350,92744199,637733462,424167799226
2016-01-14,0,24159812648,420059853764,1351300,90157483,644689652,420704543416
2016-01-15,0,21281323158,412017156874,2202592,88097175,614315699,412631472573
2016-01-18,0,22880940620,412908216832,596892,86136998,612292337,413520509169
2016-01-19,0,26562328352,411926731181,531000,84259831,626328155,412553059336
2016-01-20,0,24839854251,409586464227,1042400,81415420,597467501,410183931728
2016-01-21,0,22261040119,405270608058,1758300,81686605,579370977,405849979035
2016-01-22,0,19608786471,404318829793,880025,81212830,583888338,404902718131
2016-01-25,0,16952659222,402203566211,961600,81008762,584489080,402788055291
2016-01-26,0,19015095913,392046422005,2462900,81358259,530829020,392577251025
2016-01-27,0,20681629682,383390619246,701095,78303887,517920146,383908539392
2016-01-28,0,14532628141,375998689752,2890784,80538553,526558363,376525248115
2016-01-29,0,17667724585,374074144236,1309100,73411344,528515298,374602659534
2016-02-01,0,13266558820,369246465622,845300,72561773,518686590,369765152212
2016-02-02,0,17196981603,369258699665,1213641,68583695,523112893,369781812558
2016-02-03,0,14743087081,366339438448,1200100,66920426,518007482,366857445930
2016-02-04,0,18105234419,364055761650,1061600,65105799,510155003,364565916653
2016-02-05,0,11949817220,355841975713,1210000,58747650,453296615,356295272328
2016-02-15,0,15419275107,357997001779,3047141,60430950,476853093,358473854872
2016-02-16,0,23146201614,360765112587,6036202,64434010,513147277,361278259864
2016-02-17,0,23668100598,361581753584,1756440,64474896,520306139,362102059723
2016-02-18,0,26000421233,363338319105,3013985,65985667,522769539,363861088644
2016-02-19,0,21189658523,363928803190,1132653,62588592,507699937,364436503127
2016-02-22,0,27980919130,365896479440,3055227,63908502,521636713,366418116153
2016-02-23,0,24771846449,365762933506,897946,63375066,524339592,366287273098
2016-02-24,0,24126887794,366548524791,1596324,63881946,523697059,367072221850
2016-02-25,0,26004096589,359870572258,3691507,64157899,492443018,360363015276
2016-02-26,0,18515493989,357625014971,2302600,62191007,475242268,358100257239
2016-02-29,0,15954440375,349830134491,3842196,64695672,473495704,350303630195
2016-03-01,0,18113183230,348407484917,1695356,63835803,479273379,348886758296
2016-03-02,0,25495180892,350026780836,2413100,63413434,504544461,350531325297
2016-03-03,0,27911603537,351166323022,2070561,63682242,500713920,351667036942
2016-03-04,0,23107469138,346275888727,1967079,60880642,477013647,346752902374
2016-03-07,0,20098767237,348322401889,1822869,61408018,486432187,348808834076
2016-03-08,0,22259291896,348089980926,3039244,60578102,495892939,348585873865
2016-03-09,0,16951213927,346510690799,2089779,61281106,495202566,347005893365
2016-03-10,0,13872157961,344711535606,1158875,59233600,479123949,345190659555
2016-03-11,0,11493723932,343658632343,1163251,58401795,471103073,344129735416
2016-03-14,0,23305161496,346937834506,2048120,56665692,471680476,347409514982
2016-03-15,0,17262826702,344817356623,3090658,58538872,474098712,345291455335
2016-03-16,0,16262718463,343303261117,1179050,58240849,471635005,343774896122
2016-03-17,0,29186721307,348891009503,3274401,57729504,492837107,349383846610
2016-03-18,0,37543969217,350310906516,4972665,58197852,506900624,350817807140
2016-03-21,0,44265717167,357579425537,5027476,58800184,538872224,358118297761
2016-03-22,0,35501793056,360648135772,5260179,59833340,524656447,361172792219
2016-03-23,0,32057030389,363609348818,3560827,59916870,538853981,364148202799
2016-03-24,0,35358343485,363716545508,4090008,60073723,523080723,364239626231
2016-03-25,0,27097779184,365099695805,4028187,58426670,522419826,365622115631
2016-03-28,0,30137411877,365610965603,3528629,59506897,523861147,366134826750
2016-03-29,0,24754597695,364985120846,2340499,57620488,504874314,365489995160
2016-03-30,0,32605875387,368148068413,4160899,57287780,512075805,368660144218
2016-03-31,0,35317375296,368548596100,2803681,56889882,512712257,369061308357
2016-04-01,0,26351411645,365714382586,3226479,56198097,493229366,366207611952
2016-04-05,0,37728577066,372017861270,6727108,59961677,541090409,372558951679
2016-04-06,0,34447663979,373565116504,2688313,59182913,540056979,374105173483
2016-04-07,0,34620907759,373834350901,3082840,57199438,522965243,374357316144
2016-04-08,0,27926476614,372518701480,3022412,55273486,503146483,373021847963
2016-04-11,0,32275839811,375349331104,5641153,58188327,531252101,375880583205
2016-04-12,0,26684621545,373603530094,2860450,60002842,529499523,374133029617
2016-04-13,0,42497414125,378112662549,4223678,59122929,533865003,378646527552
2016-04-14,0,29193494368,379679462135,2491950,59554621,535793604,380215255739
2016-04-15,0,24429152925,377518994981,5794667,62426794,540979233,378059974214
2016-04-18,0,25111707103,377714949618,4097427,64180180,536987595,378251937213
2016-04-19,0,24134625997,378502459243,4528612,65235390,544540355,379046999598
2016-04-20,0,33052716300,371693908395,4253140,66787155,540740300,372234648695
2016-04-21,0,23272192698,369254391138,2105981,66669622,537669445,369792060583
2016-04-22,0,19544789286,368107349131,4543102,66839531,534462980,368641812111
2016-04-25,0,16372388602,367102577538,2642480,67633796,537891572,367640469110
2016-04-26,0,17122187007,367002748117,2245904,67029996,534913806,367537661923
2016-04-27,0,19195734595,365776987603,3105841,67878298,533427353,366310414956
2016-04-28,0,19965757698,365713057297,2173237,66056988,526724657,366239781954
2016-04-29,0,15766350070,362580921065,2908927,64908586,512499119,363093420184
2016-05-03,0,28504702163,367601137663,5700100,66026740,541082229,368142219892
2016-05-04,0,25786420558,368313132399,1631982,64867829,540751083,368853883482
2016-05-05,0,24057936106,370676028861,2244674,61225035,527248276,371203277137
2016-05-06,0,31502243084,364925800070,6201487,62195428,509967677,365435767747
2016-05-09,0,22648683418,362328280543,4216976,61351154,492170624,362820451167
2016-05-10,0,14717242970,359371542888,3815960,62433196,494466084,359866008972
2016-05-11,0,16749007366,356980879054,3573662,63413300,492921621,357473800675
2016-05-12,0,17345961549,355842773920,6676800,67758627,509681805,356352455725
2016-05-13,0,15426060216,353056277657,2174219,63582733,471630184,353527907841
2016-05-16,0,18182354643,354364864187,4322755,65093610,489698566,354854562753
2016-05-17,0,22711601443,354150316174,3138768,66638413,503229208,354653545382
2016-05-18,0,19231490206,351233703386,2204730,64937817,494286514,351727989900
2016-05-19,0,19850371030,351928402260,2981388,62476715,491752238,352420154498
2016-05-20,0,18325276817,350629841800,4013826,56348410,470902864,351100744664
2016-05-23,0,20147157795,350818153717,2042192,55791329,469562235,351287715952
2016-05-24,0,18156062793,350618600314,6341119,60561236,487107613,351105707927
2016-05-25,0,18851655109,350074632838,3478281,61352630,490752749,350565385587
2016-05-26,0,20500699275,350832810924,4391611,62528286,493807539,351326618463
2016-05-27,0,19030003443,349299130719,2385436,60292044,483349087,349782479806
2016-05-30,0,15577057141,349160109854,2739820,60687178,484934872,349645044726
2016-05-31,0,33768327109,354211648655,6689100,58072454,509478495,354721127150
2016-06-01,0,36146334318,356055896526,3566376,57523041,506434669,356562331195
2016-06-02,0,30074746358,359444443330,2822958,58291040,504988859,359949432189
2016-06-03,0,35256906502,359786638997,4188722,54232215,495438447,360282077444
2016-06-06,0,29025895767,362017995255,3016805,53070065,496748503,362514743758
2016-06-07,0,26561105893,363491724618,2713060,52944307,502098995,363993823613
2016-06-08,0,28010220960,362390051538,1786775,50018516,478125279,362868176817
2016-06-13,0,29312646485,360260103394,4352697,49904872,451795968,360711899362
2016-06-14,0,18074540005,358924588425,4373343,48604267,458363158,359382951583
2016-06-15,0,31860841330,363964020846,8173810,52418893,500054524,364464075370
2016-06-16,0,30131810807,363833867811,5180150,54202482,525515466,364359383277
2016-06-17,0,27524541672,362938571805,7468714,53528387,531712981,363470284786
2016-06-20,0,24116815777,364067180644,8182198,57999039,560938813,364628119457
2016-06-21,0,29948434015,363377791331,8704165,62818307,565100895,363942892226
2016-06-22,0,24835832388,365641661042,5378187,61165602,555470262,366197131304
2016-06-23,0,26676992421,365901475695,7279047,63992923,583434790,366484910485
2016-06-24,0,33089166508,365462347523,4884980,60332890,544787853,366007135376
2016-06-27,0,31558973770,370185919257,8711431,64877639,599853276,370785772533
2016-06-28,0,35067438589,372738652588,5509129,57844568,592793567,373331446155
2016-06-29,0,32665309004,374605749887,5027139,55109813,562070796,375167820683
2016-06-30,0,28730238118,375955954387,5563679,56924331,589202930,376545157317
2016-07-01,0,24905110070,375007147360,3408981,55925756,577685460,375584832820
2016-07-04,0,34589540568,379580085363,8320877,55822224,575445937,380155531300
2016-07-05,0,34031095749,381331228915,10521712,61038066,620641764,381951870679
2016-07-06,0,33003848167,383173651219,16617651,73446740,700700482,383874351701
2016-07-07,0,38899479249,386013007959,9268271,75556520,699305083,386712313042
2016-07-08,0,31983545849,385152341160,10706177,78717687,722690459,385875031619
2016-07-11,0,35532428068,385839187853,10175874,70861058,698548939,386537736792
2016-07-12,0,38637706509,387942883864,9752620,70221013,738645599,388681529463
2016-07-13,0,40480632873,390331099588,7159382,70113902,747479564,391078579152
2016-07-14,0,32891596076,391710863704,4408029,69367920,743170829,392454034533
2016-07-15,0,31837526539,390962853536,4923617,69399786,746076388,391708929924
2016-07-18,0,30303484357,393071094199,5448215,70508050,757903433,393828997632
2016-07-19,0,28168447762,395551259363,6871973,71402076,776645998,396327905361
2016-07-20,0,26038011069,395925424976,22148308,88770071,839379639,396764804615
2016-07-21,0,28350972629,395469828323,9644546,88146344,866076062,396335904385
2016-07-22,0,28272987656,394500460181,8423391,85670084,845072915,395345533096
2016-07-25,0,26317906353,395350135255,5497181,82289737,823381490,396173516745
2016-07-26,0,26036084643,396457443656,6695543,84588176,846984328,397304427984
2016-07-27,0,40077927365,390475263964,8723960,79795063,800155228,391275419192
2016-07-28,0,26617650851,388343977890,8920423,80946136,814460331,389158438221
2016-07-29,0,19281063734,385680751071,6239943,79665573,789482328,386470233399
2016-08-01,0,18719900548,383762696120,6838793,68625689,738545404,384501241524
2016-08-02,0,13450596083,382892321734,10363639,73856666,779187729,383671509463
2016-08-03,0,15764416395,382354486220,9002116,78735799,807837087,383162323307
2016-08-04,0,20207754087,383325989005,7024970,78815665,826427259,384152416264
2016-08-05,0,17873537427,381275123721,8215545,80376773,846993206,382122116927
2016-08-08,0,20650848395,383280692414,9000114,81266036,847209325,384127901739
2016-08-09,0,23373078872,385033514768,8716533,82892145,884707507,385918222275
2016-08-10,0,23291258482,386889913526,9181314,84601127,879904468,387769817994
2016-08-11,0,21532221324,387328864009,9634641,83553319,877692339,388206556348
2016-08-12,0,20137757361,385738773943,8004636,78985759,839059125,386577833068
2016-08-15,0,40429860358,390060855175,15610263,73186502,902896198,390963751373
2016-08-16,0,34729196338,392943224763,8460428,69694201,893125785,393836350548
2016-08-17,0,30707008629,394169383388,15711870,78000223,920725377,395090108765
2016-08-18,0,31619330529,395680122388,12283993,80693239,936431022,396616553410
2016-08-19,0,25434211760,395762967481,5631489,77532528,907626017,396670593498
2016-08-22,0,24431927634,396486712819,7917172,77698792,889332501,397376045320
2016-08-23,0,20799118089,396447065441,8507867,78566605,894482582,397341548023
2016-08-24,0,19969756603,397106022692,11189646,71123666,869404393,397975427085
2016-08-25,0,22633766687,396900530333,21264237,80013731,887214029,397787744362
2016-08-26,0,21635063284,395649660961,10626326,77339498,825323999,396474984960
2016-08-29,0,19446515943,396330195592,7515529,76465993,821525361,397151720953
2016-08-30,0,19205781586,396776383866,11689099,80168720,854135336,397630519202
2016-08-31,0,20920039177,397999248893,11732254,83118834,901468958,398900717851
2016-09-01,0,20916321134,397570811304,8938935,81072137,891846504,398462657808
2016-09-02,0,19202021248,395974853401,8652380,71718340,871117401,396845970802
2016-09-05,0,17748067803,395605122665,9665686,73286226,884170548,396489293213
2016-09-06,0,27821018520,399371816383,15911163,78783488,944032443,400315848826
2016-09-07,0,26094578704,399149369472,14326021,84377153,954426327,400103795799
2016-09-08,0,22319623903,400149497276,8970056,86136877,985531294,401135028570
2016-09-09,0,22704002910,398710811034,7331995,83148380,945092502,399655903536
2016-09-12,0,25079428803,397396740923,13988227,80395174,929227492,398325968415
2016-09-13,0,18843872803,396391203565,9781532,82212933,948217312,397339420877
2016-09-14,0,16312385246,393414861047,5485912,74962367,889788953,394304650000
2016-09-19,0,15153218532,394070119476,10643811,79309129,936748575,395006868051
2016-09-20,0,14501641046,394236340314,6897031,80531303,947959658,395184299972
2016-09-21,0,15850972394,394829065691,8155178,82741386,986778800,395815844491
2016-09-22,0,19015214028,394417716166,8422688,83733672,999040713,395416756879
2016-09-23,0,16623272527,392478028148,4639665,78943309,954616637,393432644785
2016-09-26,0,18130939706,391915973566,6735335,79815149,931878756,392847852322
2016-09-27,0,15441692919,391522116061,7626815,78805078,937329013,392459445074
2016-09-28,0,12647713740,391037676977,6378306,74423014,858956034,391896633011
2016-09-29,0,14316000092,389909752333,8325472,74949237,870112861,390779865194
2016-09-30,0,11400848337,383297558357,3749476,68656107,811493882,384109052239
2016-10-10,0,23468260087,388279269192,12875193,74686401,889042257,389168311449
2016-10-11,0,20831288895,389740878122,15403268,82712848,912834215,390653712337
2016-10-12,0,19325740621,391864118459,9005341,86320600,966327434,392830445893
2016-10-13,0,18747946985,393092880883,12965275,92001236,1006366675,394099247558
2016-10-14,0,17922095120,393264940936,10190918,92379450,1031930712,394296871648
2016-10-17,0,19310828825,393765818993,9178762,93833823,1019022175,394784841168
2016-10-18,0,21752782833,396177389390,17560337,101895066,1106977821,397284367211
2016-10-19,0,21230068804,396905867316,7629957,96330646,1060376054,397966243370
2016-10-20,0,18866704001,397927575749,8024158,99890778,1105853402,399033429151
2016-10-21,0,19897354308,395953271652,8509168,94512517,1039793685,396993065337
2016-10-24,0,23617448635,397994048784,13893714,92048137,1067955305,399062004089
2016-10-25,0,21968684742,398931677232,12064154,92866643,1056689938,399988367170
2016-10-26,0,22337054454,399319081067,15912360,101588310,1093100247,400412181314
2016-10-27,0,18918533936,400160592773,6631838,101051912,1093995232,401254588005
2016-10-28,0,18780648462,397174457103,9551450,98357304,1089697185,398264154288
2016-10-31,0,16391859605,397452281214,7399467,90358180,1016416473,398468697687
2016-11-01,0,18779948673,398646778493,10543103,87110761,993416176,399640194669
2016-11-02,0,21157447475,397938926858,9968011,81578586,979079650,398918006508
2016-11-03,0,26648367834,400558708029,12894325,84850406,1029927904,401588635933
2016-11-04,0,20042793355,399195416354,10515940,73892775,906861667,400102278021
2016-11-07,0,20562219961,400518057984,11451738,75622642,908871757,401426929741
2016-11-08,0,20288597967,401188330399,10494743,74110187,880649992,402068980391
2016-11-09,0,26167494964,402213088135,11855629,76149741,910645602,403123733737
2016-11-10,0,25735329572,404451117866,11084843,76738997,917119182,405368237048
2016-11-11,0,30854767132,403981092732,13735010,73533027,871380787,404852473519
2016-11-14,0,32753377345,406357807606,11664026,74759926,887039233,407244846839
2016-11-15,0,26807565051,408574777587,13381382,77799399,918490862,409493268449
2016-11-16,0,26682271336,409765594730,10523437,75033277,889884869,410655479599
2016-11-17,0,22169038797,409874536216,8630648,73189461,871829581,410746365797
2016-11-18,0,21100913118,408848227402,8310855,72585501,854772665,409703000067
2016-11-21,0,22979485049,411210516959,9872817,71380356,838269541,412048786500
2016-11-22,0,27474463042,414404932883,11986220,73962413,867383404,415272316287
2016-11-23,0,29754857944,414442382028,11872194,75298244,901307476,415343689504
2016-11-24,0,27438671330,414718456434,10085013,74336875,896053634,415614510068
2016-11-25,0,27895056827,414763872691,10933684,72750134,895776741,415659649432
2016-11-28,0,28943928074,417033258657,11270634,75266118,897166947,417930425604
2016-11-29,0,28221336258,416610672433,13876803,78718008,920684429,417531356862
2016-11-30,0,25729353024,418866233722,8451948,75325551,870261947,419736495669
2016-12-01,0,23733459750,413799249921,10862928,78913184,929818301,414729068222
2016-12-02,0,25391709907,412178780476,9418167,75490895,884890749,413063671225
2016-12-05,0,21451668754,411035262002,9947572,74452910,900573292,411935835294
2016-12-06,0,17679446029,410874892524,9303696,72934382,868943122,411743835646
2016-12-07,0,18039666760,411690734368,10227961,74305128,876960423,412567694791
2016-12-08,0,18062229925,410814912650,10956140,77591078,902408170,411717320820
2016-12-09,0,17995484187,408979317619,8883228,73200524,853927099,409833244718
2016-12-12,0,23999487213,404526591160,13108002,74298243,835606290,405362197450
2016-12-13,0,15475611704,402988518796,11488282,70741485,785581967,403774100763
2016-12-14,0,15295587357,401736494191,11210278,69731863,776642539,402513136730
2016-12-15,0,15854039977,402724650672,9615152,68059545,762302875,403486953547
2016-12-16,0,13174990779,401027051146,7426785,65570269,746021583,401773072729
2016-12-19,0,12802880869,400477460646,10156314,64344728,713260810,401190721456
2016-12-20,0,12357305118,400522979991,8423912,62585060,693856834,401216836825
2016-12-21,0,12726951849,399771689847,7093585,60040105,670377205,400442067052
2016-12-22,0,11666890316,399136808751,8474196,61397558,699637426,399836446177
2016-12-23,0,12511981751,397449615771,9512971,61459366,689104021,398138719792
2016-12-26,0,13068764263,398026075858,10693161,62703378,706403811,398732479669
2016-12-27,0,10784761736,397445365428,9017332,60301056,673591353,398118956781
2016-12-28,0,10601340250,397511656554,11641898,62861594,676641306,398188297860
2016-12-29,0,10481995995,397325973437,8379921,62022930,658060932,397984034369
2016-12-30,0,9047930042,394025602787,5812475,52975284,571221475,394596824262
2017-01-03,0,11949189614,394745974498,11236155,57763822,620476395,395366450893
2017-01-04,0,15111669330,394327908532,10668831,57911994,615399668,394943308200
2017-01-05,0,14060627375,393350744378,10984438,60645257,648842890,393999587268
2017-01-06,0,13797467633,391952345803,8052902,54472696,584344284,392536690087
2017-01-09,0,13112550223,391750039175,11537817,56296264,596182624,392346221799
2017-01-10,0,13157783401,391175614544,10468762,58168501,620521071,391796135615
2017-01-11,0,12361362225,390542979631,11533943,60529909,618242435,391161222066
2017-01-12,0,11647984852,389794524910,15121077,65290623,621970210,390416495120
2017-01-13,0,11116147615,387631682716,12087177,57985858,604390844,388236073560
2017-01-16,0,15356043369,382711116602,15134330,58960261,607145568,383318262170
